<pre>
name:                    Arabic
</pre>

=== General ===
<pre>
add:                       أضف
apply:                     طبِّق
cancel:                    ألغِ
clear:                     امحُ
close:                     أغلق
continue:                  إستمر
copy:                      انسخ
delete:                    احذف
error:                     خطأ
exit:                      خروج
minimizewindow:            تصغير
no:                        لا
ok:                        موافق
remove:                    أزل
rename:                    غير الاسم
restorewindow:             استعد
save:                      احفظ
selectfile:                اختر ملفا
yes:                       نعم
agf:                    استرجع, حسن نية, مع تخصيص السبب
import:                 استورد من اعدادات موحدة
</pre>

=== Edit types ===
<pre>
edittype-blocknote:        إخطارات المنع
edittype-deletenote:       إخطارات طلب الحذف
edittype-deletetag:        وسوم نقاش الحذف
edittype-deletereq:        تعديلات أخرى في نقاش الخذف
edittype-manual:           تعديلات يدوية
edittype-message:          رسائل المستخدم
edittype-note:             إِخطارات أخرى
edittype-prodtag:          وسوم ترشيح للحذف
edittype-protectreq:       طلبات حماية
edittype-report:           تقارير
edittype-revert:           استرجاعات
edittype-speedytag:        وسوم الحذف السريع
edittype-tag:              وسوم أخرى
edittype-warning:          إنذارات
</pre>

=== About form ===
<pre>
about-contributors:        المطورون:
</pre>

=== Block form ===
<pre>
block-title:               منع {0} ء
block-reason:              السبب:
block-duration:            المدة:
block-message:             رسالة نقاش المستخدم:
block-anononly:            امنع المستخدمين المجهولين فقط
block-creation:            امنع إنشاء حسابات جديدة
block-autoblock:           فعل المنع التلقائي
block-email:               امنع البريد الإلكتروني
block-usertalk:            نقاش
block-usercontribs:        مساهمات
block-blockloglabel:       سجل المنع:
block-warnloglabel:        إنذارات:
block-sharedipwarning:     ملاحظة:{0} تم وسمه كعنوان اي بي مشترك.
block-sensitivewarning:    عنوان الأي بي هذا يعتبر "حساسا" للسبب التالي:\n\n   {0}\n\nالمتابعة رغم ذلك?
block-rangeblockwarning:   هذا المنع سيتجاوز الضرر الناتج في نطاق المنع. إستمر؟\n .تأثر {0} بالفعل من نطاق المنع على {1} ء
</pre>

=== Closing form ===
<pre>
closing-whitelist:         تحديث قائمة المستخدم البيضاء...
closing-config:           تحديث الصفحة الفرعية للإعدادات...
</pre>

=== Configuration form ===
<pre>
config-summ:               تخصيص استرجاع ملخصات القوالب
config-title:              خيارات
config-rememberme:         تذكر اسم المستخدم
config-rememberpassword:   تذكر كلمة المرور
config-autowhitelist:      مستخدمون (القائمة البيضاء) تلقائيا
config-openinbrowser:      افتح وصلات التصفح في صفحات متصفح جديدة
config-shownewedits:       أظهر التحريرات الجديدة في الصفحة المحددة وقت حدوثها
config-preloads:           فعل التحميل المسبق للفروق
config-ircmode:            استخدم تلقيم الآي آر سي لأحدث التغييرات إن أمكن
config-ircport:            منفذ آي آر سي
config-difffontsize:       حجم خط الفرق
config-logfile:            ملف السجل
config-viewlocalconfig:    اعرض مجلد التضبيطات المحلي
config-trayicon:           أظهر أيقونة لوحة النظام
config-startupmessage:     أظهر رسالة بدء التشغيل
config-showlog:            أظهر السجل
config-showqueue:          أظهر طابور الاسترجاع
config-rightalignqueue:    أظهر الطابور في يمين النافذة
config-showtooltips:       أظهر التلميحات في القائمة
config-shownewmessages:    اعرض شريط الرسائل الجديدة
config-shortcutlist:       مفاتيخ الاختصار
config-shortcutaction:     إجراء
config-shortcut:           مختصر
config-changeshortcut:     غير الاختصار لـ {0}ء
config-noshortcut:         لا شيء
config-defaults:           مبدئيات
config-minor:              طفيف
config-watchlist:          أضف لقائمة مراقباتي
config-defaultsummary:     الملخص المبدئي للتعديلات اليدوية
config-undosummary:        الملخص عند رجوعك عن تعديلاتك الخاصة
config-confirmmultiple:    أكد استرجاعات متعدد لتعديل لنفس المستخدم
config-confirmsame:        أكد الرجوع إلى تعديل قام به نفس المستخدم الذي تقوم باسترجاع تعديله
config-confirmselfrevert:  أكد الرجوع عن تعديلاتك الخاصة (ما عدا التراجع)
config-confirmwarned:      أكد استرجاعا إلى تعديل قام به مستخدم تم تحذيره
config-confirmrange:       أكد الرجوع إلى تعديل قام به مجهول من نفس /16 نطاق المستخدم الذي تسترجع تعديله
config-confirmpage:        اكد الرجوع في الصفحات التي تم تجاهلها
config-autoadvance:        بعد الرجوع، اذهب إلى الصفحة التالية في الطابور
config-userollback:        استعمل خاصية الاسترجاع إن أمكن
config-revertsummaries:    الرجوع عن ملخصات موجودة في القائمة
config-clearsummaries:     إن الملخصات المدخلة يدويا يتم تذكرها عبر الجلسات؛ انقر لمحوها
config-reportlinkexamples: ضمن وصلات لحالات تخريب في الإخطارات
config-extendreports:      مدد الإخطار بعد تخريب إضافي
config-autoreportgroup:    إخطار تلقائي
config-autoreport:         حين إنذار المستخدم إنذارا نهائيا
config-reportnone:         لا تفعل شيئا
config-reportprompt:       إخطار فوري 
config-reportauto:         قم بالإخطار تلقائيا
config-templates:          قوالب رسائل المستخدم
config-templatetext:       اعرض النص
config-template:           قالب
config-highlightgroup:     ألوان إبراز الصيغة
config-useadminfunctions:  استخدم الصلاحيات الإدارية إن أمكن
config-promptforblock:     سل عن المنع عند تحذير مستخدم مع إنذار نهائي
config-blockreason:        سبب المنع المبدئي
config-blocktime:          مدة المنع المبدئية
config-blocktimeanon:      مستخدمون مجهولون
config-blocktimereg:       مستخدمون مسجلون
config-summaryprompt:      أدخل ملخصا
config-defaultsprompt:     استرجاع المبدئيات?
config-logbrowsetitle:     موقع ملف السجل
config-shortcutconflict:   المختصر '{0}' يتعارض مع مختصر موجود لـ '{1}'.ء
</pre>

=== Delete form ===
<pre>
delete-title:              احذف {0}ء
delete-reason:             سبب:
delete-deletionlog:        سجل الحذف:
</pre>

=== Edit form ===
<pre>
edit-title:                تعديل {0}ء
edit-summary:              ملخص:
edit-minor:                تعديل طفيف
edit-watch:                راقب هذه الصفحة
edit-page:                 صفحة
edit-edit:                 عدل
edit-view:                 اعرض
edit-page-savetofile:      احفظ بالملف...
edit-page-save:            احفظ
edit-page-cancel:          ألغ
edit-edit-undo:            تراجع
edit-edit-redo:            أعد
edit-edit-cut:             قص
edit-edit-copy:            انسخ
edit-edit-paste:           ألصق
edit-edit-delete:          احذف
edit-edit-selectall:       اختر الكل
edit-edit-find:            بحث
edit-view-syntax:          تلوين الصياغة
edit-matchcase:            تطابق
edit-find:                 جد:
edit-replace:              استبدل:
edit-findnext:             تالي
edit-findprevious:         سابق
edit-replaceall:           استبدل الكل
edit-edittab:              تعديل
edit-previewtab:           مشاهدة
edit-changestab:           تغييرات
edit-searchnotfound:       العبارة غير موجودة
edit-searchwrapstart:      وصلنا نهاية الصفحة، تابع من البداية
edit-searchwrapend:        وصلنا بداية الصفحة، بعد المتابعة من النهاية
</pre>

=== E-mail form ===
<pre>
email-title:               راسل {0}ء
email-subject:             الموضوع:
email-message:             الرسالة:
email-ccme:                أرسل لي نسخة
email-send:                أرسل
</pre>

=== IRC feed ===
<pre>
irc-connected:             تم الاتصال بتلقيم آي آر سي لأحدث التغييرات
irc-connecting:            قيد الاتصال بتلقيم آي آر سي لأحدث التغييرات؛ قد يستغرق الأمر برهة
irc-disconnected:          انقطع الاتصال بتلقيم آي آر سي لأحدث التغييرات؛ معاودة الاتصال
irc-nochannel:             قناة آي آر سي ل{0} غير موجودة؛ استخدام استعلامات واجهة برمجة تطبيقات أبطأ بدلاً منها
irc-error:                 تعذر الاتصال بملقم آي آر سي لأحدث التغييرات. استخدام استعلامات واجهة برمجة تطبيقات أبطأ بدلاً منها
</pre>

=== List form ===
<pre>
list-actions:              إجراءات ومرشحات...
list-browsetitle:          أضف ملفا نصيا للقائمة
list-combine:              اجمع
list-copyto:               انسخ إلى
list-count:                {0} عناصر
list-deleteconfirm:        هل أحذف القائمة '{0}'؟
list-duplicatename:        هنالك قائمة بالاسم '{0}'. اختر اسما آخر.
list-intersect:            تقاطع
list-limit:                حتى:
list-listempty:            لا عناصر في القائمة\nأدخل مصدرا وانقر على "أضف"
list-nolists:              لايوجد قوائم محددة\nأنقر على "أضف" لإنشاء قائمة
list-query-cancelled:      تم إلغاؤه.
list-query-fail:           فشل الاستعلام.
list-query-noresults:      الاستعلام لم يرجع نتائجا.
list-query-progress:       الاستعلام قيد التنفيذ...
list-query-results:        {0} نتائج.
list-renameprompt:         أدخل اسما جديدا:
list-replace:              استبدل
list-savefailed:           تعذر حفظ القائمة:
list-savetitle:            احفظ القائمة
list-sourcetype:           نوع المصدر:
list-start:                من:
list-stop:                 توقف
list-title:                باني القوئم
</pre>

=== Login ===
<pre>
login-language:            اللغة:
login-project:             المشروع:
login-username:            اسم المستخدم:
login-password:            كلمة السر:
login-proxygroup:          إعدادات الوسيط
login-proxy:               استخدم خادوما وسيطا
login-proxyaddress:        عنوان:
login-proxyport:           منفذ:
login-proxydomain:         نطاق:
login-start:               ولوج
login-translate:           ترجم...
login-captchatitle:        يتطلب الولوج كابتشا

login-progress-start:      قيد الولوج...
login-progress-language:   ملفات الرسائل قيد التحديث...
login-progress-global:     الخيارات العمومية قيد الفحص...
login-progress-config:     صفحات الخيارات قيد الفحص...
login-progress-userlist:   قائمة المستخدمين قيد الفحص...
login-progress-whitelist:  قيد استرجاع القائمة البيضاء للمستخدم...

login-error-admin:         استخدام Huggle في هذا المشروع يحتاج حسابا إداريا.
login-error-age:           استخدام Huggle في هذا المشروع يحتاج حسابا عمره {0} يوما على الأقل.
login-error-alldisabled:   تم تعطيل Huggle حاليا في كل المشاريع.
login-error-approval:      استخدام Huggle في هذا المشروع يحتاج تصديقا.
login-error-autoconfirmed: استخدام Huggle في هذا المشروع يستلزم ان يكون حسابك مستخدم مؤكد تلقائياً
login-error-cancelled:     ملغى.
login-error-captcha:       خطأ في كلمة السر أو كود التصديق
login-error-config:        فشل تحميل صفحات الخيارات.
login-error-count:         استخدام Huggle في هذا المشروع يحتاج {0} تعديلات على الأقل.
login-error-disabled:      Huggle غير مفعلة في حسابك، راجع صفحة خيارات المستخدم.
login-error-global:        تعذر تحميل صفحة الخيارات العمومية.
login-error-invalid:       اسم مستخدم خاطئ.
login-error-language:      تعذر تحميل ملفات الرسائل.
login-error-nocaptcha:     الكابتشا لم تحل.
login-error-noconfig:      ليس لهذا المشروع صفحة خيارات لبرمجية Huggle.
login-error-nouser:        مستخدم غير موجود.
login-error-password:      كلمة سر خاطئة.
login-error-projdisabled:  Huggle معطل حاليا في هذا المشروع.
login-error-rollback:      استخدام Huggle في هذا المشروع يتطلب الاسترجاع
login-error-unknown:       تعذر الولوج.
login-error-userlist:      تعذر تحميل قائمة المستخدمين.
login-error-version:       هذا الإصدار قديم، يرجى تحديث البرمجية.
login-error-whitelist:     تعذر تحميل قائمة المستخدمون البيضاء
</pre>

=== Main window ===
<pre>
main-page:                 الصفحة
main-user:                 مستخدم
main-contribs:             مساهمات
main-history:              تاريخ
main-new-messages:         لديك رسائل جديدة؛ اختر النظام -> اعرض الرسائل الجديدة أو اضغط (م) لعرضهم
main-system:               النظام
main-system-messages:      اعرض الرسائل الجديدة
main-system-reconnectirc:  عاود الاتصال بتلقيم آي آر سي
main-system-savelog:       احفظ السجل...
main-system-lists:         باني القوائن...
main-system-requests:      الطلبات...
main-system-statistics:    إحصائيات...
main-system-showlog:       أظهر السجل
main-system-showqueue:     أظهر الطابور
main-system-showtwoqueues: أظهر طابورين
main-system-options:       الخيارات...
main-system-logout:        خروج
main-system-exit:          خروج
main-queue:                طابور
main-queue-next:           تالي
main-queue-trim:           تقليم
main-queue-clear:          امسح الحالي
main-queue-count:          {0} عناصر
main-queue-query:          الاستعلام قيد الإجراء...
main-queue-reset:          تصفير
main-queue-clearall:       امسح الكل
main-queue-options:        إدارة الطوابير...
main-goto:                 اذهب إلى
main-goto-mytalk:          صفحة نقاشي
main-goto-mycontribs:      مساهماتي
main-revision:             مراجعة
main-revision-view:        معاينة
main-revision-revert:      استرجاع
main-revision-previous:    سابق
main-revision-next:        تالي
main-revision-latest:      الأخير
main-revision-sight:       ناظر
main-page-switchtotalk:    حول إلى صفحة النقاش
main-page-switchtosubject: حول إلى صفحة الموضوع
main-page-switchtoarticle: حول إلى المقالة
main-page-viewlatest:      شاهد المراجعة الأخيرة
main-page-history:         اجلب التاريخ
main-page-historypage:     أظهر صفحة التاريخ
main-page-edit:            عدل
main-page-tag:             وسم
main-page-reqdeletion:     اطلب الحذف
main-page-reqprotection:   اطلب الحماية
main-page-watch:           راقب
main-page-unwatch:         لا تراقب
main-page-purge:           امسح اختزان الصفحة
main-page-patrol:          علم كمراجعة
main-page-move:            انقل...
main-page-protect:         احم...
main-page-delete:          احذف...
main-user-info:            أظهر معلومات المستخدم
main-user-ignore:          تجاهل
main-user-unignore:        لا تتجاهل
main-user-contribs:        استرد المساهمات
main-user-talk:            معاينة نقاش المستخدم
main-user-message:         رسالة...
main-user-email:           بريد إلكتروني...
main-user-warn:            نبه...
main-user-report:          أبلغ
main-user-block:           امنع...
main-browser:              متصفح
main-browser-newtab:       صفحة تبويب جديدة
main-browser-closetab:     اغلق صفحة التبويب
main-browser-closeothers:  اغلق صفحات التبويب الأخرى
main-browser-back:         خلف
main-browser-forward:      أمام
main-browser-open:         عرض هذا في متصفح خارجي
main-browser-newedits:     أظهر التعديلات الجديدة للصفحة
main-browser-newcontribs:  أظهر مساهمات المستخدم الجديدة
main-help:                 مساعدة
main-help-documentation:   المستندات
main-help-feedback:        رأيك
main-help-about:           عن Huggle...
main-addqueue:             أضف...
main-savelogtitle:         احفظ السجل
main-usermessageother:     رسالة أخرى...
main-advanced:             متقدّم...
main-stats:                {0} حرر في الدقيقة, {1} استرجع في الدقيقة

main-tip-revertwarn:       استرجع هذه النسخة ونبه المستخدم
main-tip-nextdiff:         اظهر النسخة التالية في الصف
main-tip-revert:           اجلب هذه النسخة
main-tip-template:         أرسل رسالة قالب الى المستخدم
main-tip-warn:             نبه المستخدم
main-tip-cancel:           إلغ جميع إجراءات النسخ المعلقة
main-tip-undo:             تراجع عن الإجراءات الأخيرة
main-tip-browserback:      خلف
main-tip-browserforward:   أمام
main-tip-browseropen:      اعرض هذا في متصفح خارجي
main-tip-browsernewtab:    افتح صفحة تبويب جديدة
main-tip-browserclosetab:  اغلق صفحة التبويب
main-tip-history:          اجلب تاريخ الصفحة
main-tip-historyprev:      اعرض النسخة السابقة لهذه الصفحة
main-tip-historynext:      اعرض النسخة التالية لهذه الصفحة
main-tip-historylast:      اعرض اخر نسخة لهذه الصفحة
main-tip-historydifftocur: اظهر الاختلاف بين هذه النسخة واخر نسخة
main-tip-contribs:         اجلب مساهمات المستخدم
main-tip-contribsprev:     اظهر النسخة السابقة بواسطة هذا المستخدم
main-tip-contribsnext:     اظهر النسخة التالية بواسطة هذا المستخدم
main-tip-contribslast:     اظهر اخر نسخة بواسطة هذا المستخدم
main-tip-pageview:         عاين هذه النسخة
main-tip-pageedit:         عدل هذه الصفحة
main-tip-pagewatch:        راقب هذه الصفحة
main-tip-pagetag:          اوسم هذه الصغحة
main-tip-pagetagdelete:    وسم هذه الصفحة للشطب
main-tip-pagedelete:       احذف هذه الصفحة
main-tip-userinfo:         أظهر معلومات عن المستخدم
main-tip-usertalk:         أظهر صفحة نقاش المستخدم
main-tip-usermessage:      راسل هذا المستخدم
main-tip-userignore:       تجاهل كافة مساهمات هذا المستخدم
main-tip-userreport:       أخطر عن هذا المستخدم
main-tip-userblock:        امنع هذا المستخدم
</pre>

=== Message form ===
<pre>
message-title:             رسالة {0}ء
message-help:              حدد العنوان أو الملخص او كلاهما. لدى انعدام الملخص سيتم استخدام العنوان؛ لدى انعدام العنوان لن تتم إضافة ترويسة
message-subject:           العنوان:
message-message:           الرسالة:
message-summary:           الملخص:
message-autosign:          ذيل التوقيع تلقائيا.
</pre>

=== Move form ===
<pre>
move-title:                انقل {0}ء
move-target:               الوجهة:
move-reason:               السبب:
move-movetalk:             انقل صفحة النقاش
</pre>

=== Prod form ===
<pre>
prod-title:                ترشيح حذف {0}ء
prod-reason:               السبب:
</pre>

=== Protect form ===
<pre>
protect-title:             احمِ {0}ء
protect-request-title:     طلب حماية {0}ء
protect-reason:            السبب:
protect-expiry:            إنتهاء:
protect-log:               سجل الحماية:
protect-currentlevel:      درجة الحماية الحالية:
protect-type:              نوعية الحماية:
protect-none:              لا شيء
protect-semiprotection:    حماية جزئية
protect-fullprotection:    حماية كاملة
protect-moveprotection:    حماية من النقل
</pre>

=== Queue form ===
<pre>
queue-title:               عنوان:
queue-queues:              طوابير:
queue-typegroup:           نوع الطابور:
queue-listselector:        قائمة:
queue-listbuilder:         باني القوائم...
queue-sortorder:           نظام الفرز:
queue-removeviewed:        أزل التعديلات عند مشاهدتها
queue-removeold:           أزل التعديلات القديمة لنفس الصفحة
queue-removeafter:         أزل التعديلات بعد
queue-removeaftertime:     دقائق
queue-preload:             فعل التحميل المسبق للمراجعات عند اختيار هذا الطابور
queue-ignorepages:         تجاهل تعديلات الصفحات الموجودة في قائمة الصفحات المتجاهلة
queue-traynotification:    أظهر إعلاما في لوحة النظام عند إضافة مراجعة لهذا الطابور
queue-diffsgroup:          فرق
queue-nodiffs:             حمل الفروق فقط عند معاينة المراجعة
queue-preloaddiffs:        حمل الفروق مسبقاً عندما يكون الطابور نشطاً
queue-alldiffs:            حمل الفروق لكل مراجعة في الطابور
queue-pagefiltersgroup:    مرشحات عنوان الصفحة
queue-pageregex:           المصطلح الدائم لنتيجة البحث عن العناوين
queue-namespaces:          اسماء النطاق:
queue-applylabel:          انقر على تطبيق لاضافة هذه المرشحات إلى قائمة صفحة موجودة.
queue-editfiltersgroup:    عدل المرشحات
queue-userregex:           المصطلح الدائم لنتيجة البحث عن اسم مستخدم:
queue-summaryregex:        المصطلح الدائم لنتيجة البحث عن ملخص:
queue-filternewpage:       صفحة جديدة
queue-filterownuserspace:  مساحة المستخدم
queue-filteranonymous:     مستخدم مجهول
queue-filterignored:       مستخدم متجاهل
queue-filterreverts:       استرجع
queue-filternotifications: إشعار
queue-filterwarnings:      تحذير
queue-filtertags:          وسم
queue-filterbot:           تعديل بوت
queue-filterassisted:      مساعدة التحرير
queue-filterhuggle:        Huggle تحرير
queue-filterme:            تعديلي
queue-examplelabel1:       يستدعي خاصية
queue-examplelabel2:       الغاء خاصية
queue-examplelabel3:       لا تفحص هذه الخاصية
queue-usergroup:           أظهر تعديلات هؤلاء المستخدمين فقط
</pre>

=== Queue trim form ===
<pre>
queuetrim-title:           تقليم الطابور
queuetrim-age:             تجاهل كل النسخ في الطابور اقدم من
queuetrim-ageunit:         دقائق
</pre>

=== Requests form ===
<pre>
requests-title:            طلبات
requests-cancelall:        ألغ الكل
requests-cancelled:        ملغي
requests-inprogress:       قيد التنفيذ
requests-failed:           فشل
requests-completed:        تم
requests-time:             وقت
requests-type:             نمط
requests-query:            استعلام
</pre>

=== Report form ===
<pre>
report-title:              أخطر عن {0}ء
report-reason:             السبب:
report-message:            الرسالة:
report-log:                التنبيهات لهذا المستخدم:
</pre>

=== Revert form ===
<pre>
revert-title:              استرجع {0}ء
revert-summary:            ملخص الاسترجاع (اتركه فارغا للنص الافتراضي):
revert-currentonly:        استرجع النسخة المعلّمة فقط
</pre>

=== Revert and warn form ===
<pre>
revertandwarn-title:       استرجع ونبه {0}
</pre>

=== Reverting ===
<pre>
revert-confirm-ignored:    استرجع التعديل بواسطة مستخدم في القائمة البيضاء '{0}'؟
revert-confirm-multiple:   هذا سيسترجع تعديلات متعددة لـ '{0}'. استمر؟
revert-confirm-range:      مؤلف النسخة المستهدفة, {1}, في نفس نطاق مؤلف النسخة الحالية, {0}, وقد يكون نفس الشخص; لضمان أن النسخة المستهدفة صحيحة قبل الاستمرار. استمر؟
revert-confirm-page:       استرجع التعديل لتجاهل الصفحة '{0}'؟
revert-confirm-same:       هذا سيسترجع الى نسخة اخرى بواسطة نفس المستخدم , {0} . استمر؟
revert-confirm-self:       هذا سيسترجع تعديلك, استمر؟
revert-confirm-warned:     هذا سيسترجع الى نسخه بواسطة {0} , هذا المستخدم تلقى تحذير مؤخراً, استمر؟
revert-error-first:        هذا اول تحرير للصفحة, لايمكن الاسترجاع
revert-only:               هذا التعديل الوحيد للصفحة
revert-creator:            اخر تعديل على الصفحة تم بواسطة الذي أنشأ الصفحة,{0} .ء
revert-delete-instead:     احذف الصفحة بدلاً عن ذلك؟
revert-speedy-instead:     وسم الصفحة للشطب السريع بدلاً عن ذلك؟
</pre>

=== Speedy form ===
<pre>
speedy-title:              {0} شطب
speedy-reason:             السبب:
speedy-parameters:         المعلمة:
speedy-notifycreator:      أعلم منشئ الصفحة
</pre>

=== Statistics form ===
<pre>
stats-title:               إحصائيات
stats-actions:             العمليات في الجلسة الحالية:
stats-session:             زمن الجلسة: {0}ء
stats-edits:               تعديلات
stats-assisted:            مساعدة التحرير
stats-huggle:              Huggle تحرير
stats-reverts:             استرجاعات
stats-warnings:            تحذيرات
stats-reports:             تقارير
stats-tags:                وسوم
stats-notifications:       الإخطارات
stats-blocks:              عمليات منع
stats-deletes:             عمليات حذف
stats-protections:         عمليات حماية
stats-allusers:            جميع المستخدمين
stats-me:                  أنا
stats-ignored:             متجاهلون
stats-anon:                مجهولون
stats-bots:                بوتات
stats-other:               آخر
</pre>

=== Tag form ===
<pre>
tag-title:                 وسم {0}ء
tag-tagselector:           أضف وسم:
tag-tags:                  عدة وسوم:
tag-summary:               تعديل:
tag-insertatend:           أضف في نهاية الصفحة
</pre>

=== Update form ===
<pre>
update-title:              يوجد إصدار جديد
update-notification:       هذا الاصدار من Huggle يحتاج الى تحديث
update-required:           يجب تحديثه الى اخر اصدار, {0}.ء
update-optional:           التحديث الى اخر اصدار, {0}, موصى به, وقد يكون مطلوب مستقبلاً.
update-prompt:             تنزيل وتشغيل اخر اصدار؟
update-download:           تحديث
update-progress:           جاري تنزيل الاصدار الجديد. . .
update-error:              فشل تنزيل الاصدار الجديد
</pre>

=== User info form ===
<pre>
userinfo-title:            معلومات المستخدم '{0}'ء
userinfo-anonymous:        مجهولون:
userinfo-ignored:          اللائحة البيضاء:
userinfo-edits:            عدد التعديلات:
userinfo-sessionedits:     التعديلات خلال الجلسة:
userinfo-sharedip:         اي بي مشترك:
userinfo-blocklog:         منع:
userinfo-warnlog:          تحذيرات:
</pre>

=== Warning form ===
<pre>
warning-title:             حذّر {0}ء
warning-levelgroup:        مستوى التحذير
warning-levelauto:         تلقائي
warning-level1:            المستوى 1
warning-level2:            المستوى 2
warning-level3:            المستوى 3
warning-level4:            المستوى 4 (النهائي)
warning-warntype:          التحذير من النوع:
warning-warnlog:           تحذيرات لهذا المستخدم:
</pre>

=== XfD form ===
<pre>
xfd-title:                 رشح {0} للحذف
xfd-category:              تصنيف:
xfd-nominationtype:        نوع الترشيح:
xfd-notify:                أخبر منشئ المقالة
xfd-reason:                السبب:
</pre>

=== Web requests ===
<pre>
error-apidisabled:         تم تعطيل واجهة برمجة التطبيقات لميدياويكي
error-exception:           خطأ في جلب '{0}'ء
error-fail:                تعذر جلب '{0}'ء
error-loggedout:           تم الخروج من الحساب، قيد تسجيل الدخول...
error-noresponse:          لا رد
error-pagemissing:         الصفحة غير موجودة
error-reloginfail:         تعذر تسجيل الدخول، يرجى إعادة تشغيل البرنامج
error-timeout:             انتهى وقت الطلب
error-unknown:             خطأ غير معروف

retrying:                  قيد إعادة المحاولة...

block-done:                تم المنع '{0}'ء
block-fail:                لم يتم المنع '{0}'ء
block-progress:            قيد المنع '{0}'...ءء

blocklog-fail:             تعذر جلب سجل المنع لـ '{0}'ء
blocklog-none:             لا يوجد سجل منع لـ '{0}'ء
blocklog-progress:         جلب سجل المنع لـ '{0}'...ء

blocknotify-fail:          لم يتم تبليغ '{0}' عن المنع
blocknotify-progress:      قيد تبليغ '{0}' عن المنع...

delete-done:               تم حذف '{0}'ء
delete-fail:               لم يتم حذف '{0}'ء
delete-progress:           قيد الحذف '{0}'...ء

deletelog-fail:            تعذر جلب سجل حذف '{0}'ء
deletelog-none:            لا يوجد سجل حذف لـ '{0}ء
deletelog-progress:        يجلب سجل حذف '{0}'...ء

diff-deleted:              تم حذف هذه النسخة.
diff-fail:                 تعذر جلب الفرق '{0}'ء

reqdelete-duplicate:       سبق أن تم وسم هذه الصفحة
reqdelete-tagfail:         لم يتم وسم '{0}' لنقاش الحذف
reqdelete-redirectfail:    الصفحة هي تحويلة ولكن لايوجد نقاش معين عن نقل الصفحة
reqdelete-tagprogress:     قيد وسم '{0}' لمناقشة الحذف

reqdelete-subpageprogress: انشىء صفحة نقاش فرعية ل '{0}'ء
reqdelete-subpagefail:     لم تنشىء صفحة نقاش فرعية ل '{0}'ء
reqdelete-logprogress:     قيد اضافة  '{0}' لسجل نقاش الحذف
reqdelete-logfail:         لم تضف '{0}' الى سجل نقاش الحذف

edit-fail:                 لم تعدل  '{0}'ء
edit-progress:             قيد تعديل '{0}'...ء

email-done:                تم ارسال ايميل الى '{0}'ء
email-fail:                فشل ارسال ايميل الى '{0}'ء
email-progress:            قيد ارسال ايميل الى '{0}'...ء

history-fail:              فشل جلب تاريخ '{0}'ء
history-progress:          قيد جلب تاريخ '{0}'ء

move-done:                 تم نقل '{0}' الى '{1}'
move-fail:                 لم يتم نقل '{0}' الى '{1}'
move-progress:             قيد نقل '{0}' الى '{1}'...

notify-fail:               لم تشعر منشىء '{0}'ء
notify-unknowncreator:     لا يمكن العثور على منشئ الصفحة

patrol-duplicate:          الصفحة بالفعل مراجعة
patrol-done:               تم تعليم '{0}' كصفحة مراجعة
patrol-fail:               لم تعلم الصفحة '{0}' كمراجعة
patrol-notfound:           لا  يمكن العثور على معرف لاخر تغييرات, الصفحة قديمة جداً
patrol-progress:           يتم الان تعليم '{0}' كمراجعه...

protect-done:              غير مستوى الحماية لـ '{0}'ء
protect-fail:              لم تغير مستوى الحماية لـ '{0}'ء
protect-progress:          قيد تغيير مستوى الحماية لـ '{0}'...ء

protectlog-fail:           فشل جلب سجل الحماية لـ '{0}'ء
protectlog-none:           لايوجد سجل حماية لـ '{0}'ء
protectlog-progress:       قيد جلب سجل الحماية لـ '{0}'...ء

purge-done:                محو اختزان '{0}'ء
purge-fail:                فشل محو اختزان '{0}'ء
purge-progress:            يتم الان محو اختزان '{0}'ء

queue-refresh-fail:        خطأ في اعادة تحديث الطابور '{0}'ء

report-duplicate:          تم الاخطار عن هذا المستخدم
report-fail:               لم يتم الاخطار عن '{0}'ء
report-progress:           قيد اخطار اداري عن '{0}'...ء

saveuserconfig-done:       حدث صفحة اعدادات المستخدم
saveuserconfig-fail:       لم تحدث صفحة اعدادات المستخدم 
saveuserconfig-progress:   يتم الان تحديث صفحة اعدادات المستخدم...

loadglobalconfig-fail:     فشل تحميل صفحة الاعدادات الموحدة
loadprojectconfig-fail:    فشل تحميل صفحة اعدادات المشروع
loaduserconfig-fail:       فشل تحميل صفحة اعدادات المستخدم

reqprotection-badformat:   صيغة الصفحة المطلوبة غير معروفة
reqprotection-duplicate:   تم طلب الحماية بالفعل
reqprotection-fail:        لم يتم طلب الحماية لـ'{0}'ء
reqprotection-progress:    قيد طلب طلب الحماية لـ'{0}'...ء

revert-cannotundo:         لا يمكن التراجع بسبب وجود تعديلات متوسطة التناقض
revert-conflict:           تم تعديل الصفحة بواسطة مستخدم متجاهل '{0}'ء
revert-fail:               لم يتم استرجاع '{0}'ء
revert-nochange:           محتوى النسخة المستهدفة مطابق لمحتوى النسخة الحالية
revert-nootheruser:        لايوجد مستخدم اخر قام بتعديل الصفحة
revert-progress:           قيد الاسترجاع '{0}'...ء

tag-alreadytagged:         تم وسم الصفحة بالفعل
tag-deleted:               تم حذف الصفحة
tag-fail:                  لم يتم وسم '{0}'ء
tag-progress:              قيد وسم '{0}'...ء

sight-done:                تم تعليم النسخة {0} من '{1}' كنسخة منظورة
sight-fail:                فشل تعليم النسخة {0} كنسخة منظورة من '{1}'
sight-progress:            قيد تعليم النسخة {0} من '{1}' كنسخة منظورة

speedy-fail:               لم يتم وسم '{0}' للحذف السريع
speedy-progress:           قيد وسم '{0}' للحذف السريع...

warnlog-fail:              فشل جلب سجل الانذار لـ '{0}'ء
warnlog-none:              '{0}' لم يسبق انذار
warnlog-progress:          قيد جلب سجل الانذار '{0}'...ء

unwatch-done:              تم استبعاد '{0}' من قائمة المراقبة
unwatch-fail:              فشل استبعاد '{0}' من قائمة المراقبة
unwatch-progress:          قيد استبعاد '{0}' من قائمة المراقبة...

usermessage-duplicate:     رسالة موجودة عن نفس الشيء 
usermessage-fail:          لم يتم ارسال رسالة '{0}'ء
usermessage-progress:      قيد ارسال رسالة '{0}'...ء

watch-done:                تمت اضافة '{0}' الى قائمة المراقبة
watch-fail:                فشل اضافة '{0}' الى قائمة المراقبة   
watch-progress:            قيد اضافة '{0}' الى قائمة المراقبة...

warn-alreadyfinal:         المستخدم تلقى التحذير الاخير بالفعل
warn-alreadyblocked:       تم منع المستخدم بالفعل
warn-alreadyreported:      تم الابلاغ عن المستخدم بالفعل
warn-oldedit:              المستخدم لم يعدل منذ اخر انذار
warn-recent:               تم انذار المستخدم قبل اقل من {0} ثواني
warn-fail:                 لم يتم انذار '{0}'ء
warn-progress:             انذار '{0}'...ء
</pre>

=== API ===
<pre>
api-help:                  لايوجد شيء معلم في قائمة استعلام واجهة برمجة التطبيقات
</pre>