<pre>
name:                      Français
</pre>

=== General ===
<pre>
add:                       Ajouter
apply:                     Appliquer
cancel:                    Annuler
clear:                     Effacer
close:                     Fermer
continue:                  Continuer
copy:                      Copier
delete:                    Supprimer
error:                     Erreur
exit:                      Sortir
minimizewindow:            Réduire
no:                        Non
ok:                        Ok
remove:                    Retirer
rename:                    Renommer
restorewindow:             Restaurer
save:                      Enregistrer
selectfile:                Parcourir...
yes:                       Oui
</pre>

=== Edit types ===
<pre>
edittype-blocknote:        Bloquer les alertes
edittype-deletenote:       Deletion request notifications
edittype-deletetag:        Deletion discussion tags
edittype-deletereq:        Other deletion discussion edits
edittype-manual:           Modifications manuelles
edittype-message:          Messe d'utilisateurs
edittype-note:             Autres alertes
edittype-prodtag:          Proposed deletion tags
edittype-protectreq:       Demandes de protection
edittype-report:           Signalements
edittype-revert:           Révocations
edittype-speedytag:        Speedy deletion tags
edittype-tag:              Autres bandeaux
edittype-warning:          Avertissements
</pre>

=== About form ===
<pre>
about-contributors:        Contributeurs :
</pre>

=== Block form ===
<pre>
block-title:               Bloquer {0}
block-reason:              Raison :
block-duration:            Durée :
block-message:             Message sur la page de discussion :
block-anononly:            Bloquer les utilisateurs anonymes seulement
block-creation:            Bloquer la création de compte
block-autoblock:           Activer l'auto-blocage
block-email:               Bloquer le courriel
block-usertalk:            Discussion
block-usercontribs:        Contributions
block-blockloglabel:       Journal de blocage :
block-warnloglabel:        Avertissements :
block-sharedipwarning:     Note : {0} est marqué comme une adresse IP partagée ou dynamique.
block-sensitivewarning:    Cette adresse IP est listée comme 'sensible' pour la raison suivante :\n\n   {0}\n\nVoulez-vous continuer quand même ?
block-rangeblockwarning:   {0} est déjà affectée par un blocage de plage sur {1}.\nCe blocage va écraser les effets du blocage de plage. Voulez-vous continuer ?
</pre>

=== Closing form ===
<pre>
closing-whitelist:         Mise à jour de la liste blanche d'utilisateurs...
closing-config:            Mise à jour des sous-pages de configuration...
</pre>

=== Configuration form ===
<pre>
config-title:              Options
config-rememberme:         Se souvenir de mon nom d'utilisateur
config-rememberpassword:   Se souvenir de mon mot de passe
config-autowhitelist:      Automatically whitelist users
config-openinbrowser:      Ouvrir les liens du navigateur dans une nouvelle fenêtre
config-shownewedits:       Show new edits to the selected page as they are made
config-preloads:           Activer le pré-chargement des diffs
config-ircmode:            Utiliser si possible le flux IRC pour les changements récents
config-ircport:            Port IRC
config-difffontsize:       Taille de police de la Diff
config-logfile:            Fichier de journal
config-viewlocalconfig:    Voir le répertoire de configuration locale
config-trayicon:           Afficher l'icône dans la barre système
config-startupmessage:     Afficher le message de démarrage
config-showlog:            Afficher le journal
config-showqueue:          Show revision queue
config-rightalignqueue:    Show queue on the right of the window
config-showtooltips:       Afficher les infobulles sur les menus
config-shownewmessages:    Afficher la barre des nouveaux messages
config-shortcutlist:       Raccourcis clavier
config-shortcutaction:     Action
config-shortcut:           Raccourci
config-changeshortcut:     Changer le raccourci pour {0}
config-noshortcut:         Aucun
config-defaults:           Défauts
config-minor:              Marquer comme mineur
config-watchlist:          Ajouter à la liste de suivi
config-defaultsummary:     Résumé par défaut pour les éditions manuelles
config-undosummary:        Résumé pour l'annulation de ses propres modifications
config-confirmmultiple:    Confirm multiple reversions of an edit by the same user
config-confirmsame:        Confirm reversion to an edit by the user being reverted
config-confirmselfrevert:  Confirm reversion of own edits (except undo)
config-confirmwarned:      Confirm reversion to an edit by a warned user
config-confirmrange:       Confirm reversion to edit by an anonymous user in the same /16 range as the user being reverted
config-confirmpage:        Confirm reversion of ignored pages
config-autoadvance:        After reverting, move to next edit in the queue
config-userollback:        Use rollback if available
config-revertsummaries:    Revert summaries available in menu
config-clearsummaries:     Summaries entered manually are remembered across sessions; click to clear these
config-reportlinkexamples: Include links to instances of vandalism in reports
config-extendreports:      Extend reports after additional vandalism
config-autoreportgroup:    Auto-report
config-autoreport:         When asked to warn a user with a final warning
config-reportnone:         Ne rien faire
config-reportprompt:       Proposer de signaler
config-reportauto:         Issue report automatically
config-templates:          Modèle de messages d'utilisateur
config-templatetext:       Afficher le texte
config-template:           Modèle
config-highlightgroup:     Couleurs de la coloration syntaxique
config-useadminfunctions:  Utiliser les fonctions administrateur (si disponible)
config-promptforblock:     Prompt for block if asked to warn a user with a final warning
config-blockreason:        Raison de blocage par défaut
config-blocktime:          Durée de blocage par défaut
config-blocktimeanon:      utilisateurs anonymes
config-blocktimereg:       utilisateurs inscrits
config-summaryprompt:      Entrez un résumé
config-defaultsprompt:     Restaurer les paramètres par défaut ?
config-logbrowsetitle:     Log file location
config-shortcutconflict:   Le raccourci '{0}' entre en conflit avec le raccourci existant pour '{1}'.
</pre>

=== Delete form ===
<pre>
delete-title:              Supprimer {0}
delete-reason:             Raison :
delete-deletionlog:        Journal de suppression :
</pre>

=== Edit form ===
<pre>
edit-title:                Modification de {0}
edit-summary:              Résumé :
edit-minor:                Modification mineure
edit-watch:                Suivre cette page
edit-page:                 Page
edit-edit:                 Modifier
edit-view:                 Afficher
edit-page-savetofile:      Enregistrer sous...
edit-page-save:            Enregistrer
edit-page-cancel:          Annuler
edit-edit-undo:            Défaire
edit-edit-redo:            Refaire
edit-edit-cut:             Couper
edit-edit-copy:            Copier
edit-edit-paste:           Coller
edit-edit-delete:          Supprimer
edit-edit-selectall:       Sélectionner tout
edit-edit-find:            Trouver
edit-view-syntax:          Coloration de sytaxe
edit-matchcase:            Respecter la casse
edit-find:                 Trouver :
edit-replace:              Remplacer :
edit-findnext:             Suivant
edit-findprevious:         Précédent
edit-replaceall:           Remplacer tout
edit-edittab:              Modifier
edit-previewtab:           Aperçu
edit-changestab:           Changements
edit-searchnotfound:       Phrase non trouvée
edit-searchwrapstart:      Reached end of page, continued from top
edit-searchwrapend:        Reached top of page, continued from end
</pre>

=== E-mail form ===
<pre>
email-title:               Envoyer {0} par courriel
email-subject:             Objet :
email-message:             Message :
email-ccme:                M'envoyer par courriel une copie de ce message
email-send:                Envoyer
</pre>

=== IRC feed ===
<pre>
irc-connected:             Connected to IRC recent changes feed
irc-connecting:            Attempting connection to IRC recent changes feed; this may take a few moments...
irc-disconnected:          Connection to IRC recent changes feed lost; reconnecting...
irc-nochannel:             IRC channel for {0} not found; using slower API queries instead
irc-error:                 Unable to connect to IRC recent changes feed. Using slower API queries instead
</pre>

=== List form ===
<pre>
list-actions:              Actions and Filters...
list-browsetitle:          Add text file to list
list-combine:              Combine
list-copyto:               Copy to:
list-count:                {0} items
list-deleteconfirm:        Delete list '{0}'?
list-duplicatename:        A list with the name '{0}' already exists. Choose another name.
list-intersect:            Intersect
list-limit:                Up to:
list-listempty:            No items in list\nEnter a source and click "Add"
list-nolists:              No lists defined\nClick "Add" to create one
list-query-cancelled:      Cancelled.
list-query-fail:           Query failed.
list-query-noresults:      Query returned no results.
list-query-progress:       Running query...
list-query-results:        {0} results returned.
list-renameprompt:         Enter new name:
list-replace:              Replace
list-savefailed:           Unable to save list:
list-savetitle:            Save list
list-sourcetype:           Source type:
list-start:                From:
list-stop:                 Stop
list-title:                List Builder
</pre>

=== Login ===
<pre>
login-language:            Langue :
login-project:             Projet :
login-username:            Nom d'utilisateur :
login-password:            Mot de passe :
login-proxygroup:          Paramètres de proxy
login-proxy:               Utiliser un serveur proxy
login-proxyaddress:        Adresse :
login-proxyport:           Port :
login-proxydomain:         Domaine :
login-start:               Connexion
login-translate:           Traduire...
login-captchatitle:        Captcha nécessaire pour se connecter

login-progress-start:      Connexion...
login-progress-language:   Updating message files...
login-progress-global:     Vérification des configurations globales...
login-progress-config:     Vérification des pages de configuration...
login-progress-userlist:   Vérification de la liste des utilisateurs...
login-progress-whitelist:  Retrieving user whitelist...

login-error-admin:         Un compte d'administrateur est nécessaire pour utiliser Huggle sur ce projet.
login-error-age:           Il faut être inscrit depuis au moins {0} jours pour utiliser Huggle sur ce projet.
login-error-alldisabled:   Huggle est actuellement désactivé sur tous les projets.
login-error-approval:      Une approbation est nécessaire pour utiliser Huggle sur ce projet.
login-error-autoconfirmed: Use of Huggle on this project requires that your account is autoconfirmed.
login-error-cancelled:     Annulé.
login-error-captcha:       Mot de passe ou code de confirmation incorrect.
login-error-config:        Échec lors du chargement des pages de configuration.
login-error-count:         Il faut avoir au moins {0} modifications à son actif pour utiliser Huggle sur ce projet.
login-error-disabled:      Huggle n'est pas activé pour votre compte, vérifiez la page de configuration d'utilisateur.
login-error-global:        Failed to load global configuration page.
login-error-invalid:       Nom d'utilisateur invalide.
login-error-language:      Failed to load message files.
login-error-nocaptcha:     Captcha non résolu.
login-error-noconfig:      Ce projet n'a pas de page de configuration de Huggle.
login-error-nouser:        L'utilisateur n'existe pas.
login-error-password:      Mot de passe incorrect.
login-error-projdisabled:  Huggle est actuellement désactivé sur ce projet.
login-error-rollback:      Use of Huggle on this project requires rollback.
login-error-unknown:       Incapable de se connecter.
login-error-userlist:      Échec lors du chargement de la liste d'utilisateurs.
login-error-version:       Cette version est passée date. Mettez à jour avec la plus récente version.
login-error-whitelist:     Failed to load user whitelist.
</pre>

=== Main window ===
<pre>
main-page:                 Page
main-user:                 Utilisateur
main-contribs:             Contributions
main-history:              Historique
main-new-messages:         Vous avez de nouveaux messages; sélectionnez Système -> Afficher les nouveaux messages ou appuyez sur M pour les afficher.
main-system:               Système
main-system-messages:      Afficher les nouveaux messages
main-system-reconnectirc:  Reconnect IRC feed
main-system-savelog:       Enregistrer le journal...
main-system-lists:         List Builder...
main-system-requests:      Demandes...
main-system-statistics:    Statistiques...
main-system-showlog:       Afficher le journal
main-system-showqueue:     Afficher la queue
main-system-showtwoqueues: Afficher deux queues
main-system-options:       Options...
main-system-logout:        Déconnexion
main-system-exit:          Quitter
main-queue:                Queue
main-queue-next:           Suivante
main-queue-trim:           Trim
main-queue-clear:          Clear current
main-queue-count:          {0} éléments
main-queue-query:          Running query...
main-queue-reset:          Réinitialiser
main-queue-clearall:       Effacer tout
main-queue-options:        Gérer les queues...
main-goto:                 Aller à
main-goto-mytalk:          Ma page de discussion
main-goto-mycontribs:      Mes contributions
main-revision:             Révision
main-revision-view:        Afficher
main-revision-revert:      Révoquer
main-revision-previous:    Précédente
main-revision-next:        Suivante
main-revision-latest:      Dernière
main-revision-sight:       Sight
main-page-switchtotalk:    Passer à la page de discussion
main-page-switchtosubject: Switch to subject page
main-page-switchtoarticle: Passer à l'article
main-page-viewlatest:      Afficher la dernière révision
main-page-history:         Récupérer l'historique
main-page-historypage:     Afficher la page d'historique
main-page-edit:            Modifier
main-page-tag:             Identifier
main-page-reqdeletion:     Demander la suppression
main-page-reqprotection:   Demander la protection
main-page-watch:           Suivre
main-page-unwatch:         Ne plus suivre
main-page-purge:           Purger
main-page-patrol:          Marquer comme vérifié
main-page-move:            Renommer...
main-page-protect:         Protéger...
main-page-delete:          Supprimer...
main-user-info:            Afficher les informations de l'utiliasteur
main-user-ignore:          Ignorer
main-user-unignore:        Ne plus ignorer
main-user-contribs:        Récupérer les contributions
main-user-talk:            Afficher la page de discussion
main-user-message:         Envoyer un message...
main-user-email:           Envoyer un courriel...
main-user-warn:            Avertir...
main-user-report:          Signaler
main-user-block:           Bloquer...
main-browser:              Parcourir
main-browser-newtab:       Nouvel onglet
main-browser-closetab:     Fermer l'onglet
main-browser-closeothers:  Fermer les autres onglets
main-browser-back:         Retour
main-browser-forward:      Forward
main-browser-open:         Afficher ceci dans un navigateur externe
main-browser-newedits:     Show new edits to page
main-browser-newcontribs:  Show new contributions by user
main-help:                 Aide
main-help-documentation:   Documentation
main-help-feedback:        Rétroaction
main-help-about:           À propos de Huggle...
main-addqueue:             Ajouter...
main-savelogtitle:         Enregistrer le journal
main-usermessageother:     Autre message...
main-advanced:             Avancé...
main-stats:                {0} modifications par minute, {1} révocation par minute

main-tip-revertwarn:       Révoquer cette révision et avertir l'utilisateur
main-tip-nextdiff:         Afficher la prochaine révision dans la queue
main-tip-revert:           Révoquer cette révision
main-tip-template:         Envoyer un message de modèle à l'utilisateur
main-tip-warn:             Avertir l'utilisateur
main-tip-cancel:           Annuler toutes les actions en attente
main-tip-undo:             Défaire les actions récentes
main-tip-browserback:      Retour
main-tip-browserforward:   Forward
main-tip-browseropen:      Afficher ceci dans un navigateur externe
main-tip-browsernewtab:    Nouvel onglet
main-tip-browserclosetab:  Fermer l'onglet
main-tip-history:          Récupérer la page d'historique
main-tip-historyprev:      Show previous revision to this page
main-tip-historynext:      Show next revision to this page
main-tip-historylast:      Show latest revision to this page
main-tip-historydifftocur: Show diff between this revision and the latest revision to this page
main-tip-contribs:         Retrieve user contributions
main-tip-contribsprev:     Show previous revision by this user
main-tip-contribsnext:     Show next revision by this user
main-tip-contribslast:     Show latest revision by this user
main-tip-pageview:         Afficher cette révision
main-tip-pageedit:         Modifier cette page
main-tip-pagewatch:        Suivre cette page
main-tip-pagetag:          Identifier cette page
main-tip-pagetagdelete:    Identifier cette page pour la suppression
main-tip-pagedelete:       Supprimer cette page
main-tip-userinfo:         Afficher les informations de l'utilisateur
main-tip-usertalk:         Afficher la page de discussion de l'utilisateur
main-tip-usermessage:      Envoyer un message à cet utilisateur
main-tip-userignore:       Ignorer toutes les contributions de cet utilisateur
main-tip-userreport:       Signaler cet utilisateur
main-tip-userblock:        Bloquer cet utilisateur
</pre>

=== Message form ===
<pre>
message-title:             Envoyer un message à {0}
message-help:              Spécifiez un ou les deux champs Objet et Résumé. Si aucun résumé n'est donné,, l'objet sera utilisé; si aucun objet n'est donné, aucune entête ne sera ajoutée.
message-subject:           Objet :
message-message:           Message :
message-summary:           Résumé :
message-autosign:          Joindre automatiquement la signature
</pre>

=== Move form ===
<pre>
move-title:                Renommer {0}
move-target:               Nouveau nom :
move-reason:               Raison :
move-movetalk:             Renommer la page de discussion
</pre>

=== Prod form ===
<pre>
prod-title:                Suppression proposée de {0}
prod-reason:               Raison :
</pre>

=== Protect form ===
<pre>
protect-title:             Protéger {0}
protect-request-title:     Demander la protection de {0}
protect-reason:            Raison :
protect-expiry:            Expiration :
protect-log:               Journal de protection :
protect-currentlevel:      Niveau de protection actuel :
protect-type:              Type de protection :
protect-none:              Aucune
protect-semiprotection:    Semi-protection
protect-fullprotection:    Protection complète
protect-moveprotection:    Protection de renommage
</pre>

=== Queue form ===
<pre>
queue-title:               Queues
queue-queues:              Queues :
queue-typegroup:           Type de queue
queue-listselector:        Liste :
queue-listbuilder:         List Builder...
queue-sortorder:           Sort order:
queue-removeviewed:        Retirer les modifications après avoir été affichées
queue-removeold:           Remove old edits to the same page
queue-removeafter:         Retirer les modifications après
queue-removeaftertime:     minutes
queue-preload:             Enable preloading of revisions when this queue is selected
queue-ignorepages:         Ignore edits to pages on the ignored pages list
queue-traynotification:    Show tray notification when a revision is added to this queue
queue-diffsgroup:          Diffs
queue-nodiffs:             Load diffs only when the revision is viewed
queue-preloaddiffs:        Preload diffs when queue is active
queue-alldiffs:            Load diffs for every revision in the queue
queue-pagefiltersgroup:    Page title filters
queue-pageregex:           Title matches regular expression:
queue-namespaces:          Espaces de nom :
queue-applylabel:          Click Apply to apply these filters to the existing page list.
queue-editfiltersgroup:    Edit filters
queue-userregex:           Username matches regular expression:
queue-summaryregex:        Summary matches regular expression:
queue-filternewpage:       Nouvelle page
queue-filterownuserspace:  User's own userspace
queue-filteranonymous:     Utilisateur anonyme
queue-filterignored:       Utilisateur ignoré
queue-filterreverts:       Révocation
queue-filternotifications: Alerte
queue-filterwarnings:      Avertissement
queue-filtertags:          Identification
queue-filterbot:           Modification de robot
queue-filterassisted:      Modification assistée
queue-filterhuggle:        Modification avec Huggle
queue-filterme:            Ma modification
queue-examplelabel1:       Require this attribute
queue-examplelabel2:       Exclude this attribute
queue-examplelabel3:       Don't check this attribute
queue-usergroup:           Show only edits from these users
</pre>

=== Queue trim form ===
<pre>
queuetrim-title:           Trim queue
queuetrim-age:             Discard all queued revisions older than
queuetrim-ageunit:         minutes
</pre>

=== Requests form ===
<pre>
requests-title:            Demandes
requests-cancelall:        Tout annuler
requests-cancelled:        Annulées
requests-inprogress:       En traitement
requests-failed:           Échouées
requests-completed:        Complétées
requests-time:             Heure
requests-type:             Type
requests-query:            Requête
</pre>

=== Report form ===
<pre>
report-title:              Signaler {0}
report-reason:             Raison :
report-message:            Message :
report-log:                Avertissements pour cet utilisateur :
</pre>

=== Revert form ===
<pre>
revert-title:              Révoquer {0}
revert-summary:            Résumé de la révocation (laisser vide par défaut) :
revert-currentonly:        Révoquer seulement la révision sélectionnée
</pre>

=== Revert and warn form ===
<pre>
revertandwarn-title:       Révoquer et avertir {0}
</pre>

=== Reverting ===
<pre>
revert-confirm-ignored:    Revert edit by whitelisted user '{0}'?
revert-confirm-multiple:   Plusieurs modifications effectuées par '{0}' seront révoquées. Voulez-vous continuer?
revert-confirm-range:      The author of the target revision, {1}, is in the same range as the author of the current revision, {0}, and may be the same person; ensure the target revision is correct before proceeding. Continue?
revert-confirm-page:       Revert edit to ignored page '{0}'?
revert-confirm-same:       This will revert to another revision by the user that is being reverted, {0}. Continue?
revert-confirm-self:       Votre propre modification sera révoquée. Voulez-vous continuer?
revert-confirm-warned:     This will revert to a revision by {0}; this user has previously been warned. Continue?
revert-error-first:        Cette modification est la première modification de cette page; incapable de révoquer.
revert-only:               Cette modification est la seule modification de cette page.
revert-creator:            Last edit was made by page creator, {0}.
revert-delete-instead:     Supprimer la page à la place?
revert-speedy-instead:     Tag for speedy deletion instead?
</pre>

=== Speedy form ===
<pre>
speedy-title:              Speedy tag {0}
speedy-reason:             Raison :
speedy-parameters:         Paramètres :
speedy-notifycreator:      Aviser le créateur de la page
</pre>

=== Statistics form ===
<pre>
stats-title:               Statistiques
stats-actions:             Actions dans cette session :
stats-session:             Heure de la session : {0}
stats-edits:               Modifications
stats-assisted:            Modifications assistées
stats-huggle:              Modifications avec Huggle
stats-reverts:             Révocations
stats-warnings:            Avertissements
stats-reports:             Signalements
stats-tags:                Identifications
stats-notifications:       Alertes
stats-blocks:              Blocages
stats-deletes:             Suppressions
stats-protections:         Protections
stats-allusers:            Tous les utilisateurs
stats-me:                  Moi
stats-ignored:             Ignorés
stats-anon:                Anonymes
stats-bots:                Robots
stats-other:               Autre
</pre>

=== Tag form ===
<pre>
tag-title:                 Identifier {0}
tag-tagselector:           Ajouter l'identification :
tag-tags:                  Identification(s) :
tag-summary:               Résumé :
tag-insertatend:           Insérer au bas de cette page
</pre>

=== Update form ===
<pre>
update-title:              Nouvelle version disponible
update-notification:       Cette version de Huggle est passée date.
update-required:           You must update to the latest version, {0}.
update-optional:           Updating to the latest version, {0}, is recommended, and may be required in future.
update-prompt:             Télécharger et exécuter la dernière version maintenant?
update-download:           Mettre à jour
update-progress:           Téléchargement de la nouvelle version...
update-error:              Échec lors du téléchargement de la nouvelle version
</pre>

=== User info form ===
<pre>
userinfo-title:            Informations de l'utilisateur '{0}'
userinfo-anonymous:        Anonyme :
userinfo-ignored:          Dans la liste blanche :
userinfo-edits:            Nombre de modifications :
userinfo-sessionedits:     Modifications dans cette session :
userinfo-sharedip:         Adresse IP partagée/dynamique :
userinfo-blocklog:         Blocages :
userinfo-warnlog:          Avertissements :
</pre>

=== Warning form ===
<pre>
warning-title:             Avertir {0}
warning-levelgroup:        Niveau d'avertissement
warning-levelauto:         Automatique
warning-level1:            Niveau 1
warning-level2:            Niveau 2
warning-level3:            Niveau 3
warning-level4:            Niveau 4 (final)
warning-warntype:          Type d'avertissement :
warning-warnlog:           Avertissements pour cet utilisateur :
</pre>

=== XfD form ===
<pre>
xfd-title:                 Nominer {0} pour la suppression
xfd-category:              Catégorie :
xfd-nominationtype:        Type de nomination :
xfd-notify:                Aviser le créateur
xfd-reason:                Raison :
</pre>

=== Web requests ===
<pre>
error-apidisabled:         The MediaWiki API is disabled
error-exception:           Error retrieving '{0}'
error-fail:                Failed to retrieve '{0}'
error-loggedout:           Le compte a été déconnecté, reconnexion...
error-noresponse:          Aucun réponse
error-pagemissing:         La page n'existe pas
error-reloginfail:         Failed to log back in, try restarting Huggle
error-timeout:             Request timed out
error-unknown:             Erreur inconnue

retrying:                  Retrying...

block-done:                '{0}' a été bloqué
block-fail:                '{0}' n'a pas été bloqué
block-progress:            Blocage de '{0}'...

blocklog-fail:             Failed to retrieve block log for '{0}'
blocklog-none:             No block log for '{0}'
blocklog-progress:         Retrieving block log for '{0}'...

blocknotify-fail:          '{0}' n'a pas été avisé du blocage
blocknotify-progress:      Avertissement à '{0}' du blocage...

delete-done:               '{0}' a été supprimé
delete-fail:               '{0}' n'a pas été supprimé
delete-progress:           Suppression de '{0}'...

deletelog-fail:            Failed to retrieve deletion log for '{0}'
deletelog-none:            No deletion log for '{0}'
deletelog-progress:        Retrieving deletion log for '{0}'...

diff-deleted:              Cette révision a été supprimée.
diff-fail:                 Failed to retrieve diff of '{0}'

reqdelete-duplicate:       Cette page est déjà identifiée
reqdelete-tagfail:         Did not tag '{0}' for deletion discussion
reqdelete-redirectfail:    The page is a redirect and no redirect discussion process is defined
reqdelete-tagprogress:     Tagging '{0}' for deletion discussion...

reqdelete-subpageprogress: Création d'une sous-page de discussion de suppression pour '{0}'...
reqdelete-subpagefail:     Did not create deletion discussion subpage for '{0}'
reqdelete-logprogress:     Adding '{0}' to deletion discussion log...
reqdelete-logfail:         Did not add '{0}' to deletion discussion log

edit-fail:                 '{0}' n'a pas été modifié
edit-progress:             Modification de '{0}'...

email-done:                Courriel envoyé à '{0}'
email-fail:                Échec lors de l'envoi du courriel à '{0}'
email-progress:            Envoie du courriel à '{0}'...

history-fail:              Failed to retrieve history of '{0}'
history-progress:          Retrieving history of '{0}' ({1})...

move-done:                 '{0}' renommé en '{1}'
move-fail:                 '{0}' n'a pas été renommé en '{1}'
move-progress:             Renommage de '{0}' en '{1}'...

notify-fail:               Le créateur de '{0} n'a pas été avisé
notify-unknowncreator:     Incapable de trouver le créateur de la page

patrol-duplicate:          Cette page est déjà vérifiée
patrol-done:               '{0}' a été marqué comme étant vérifiée
patrol-fail:               Did not mark '{0}' as patrolled
patrol-notfound:           Cannot find recent-changes id, page is too old
patrol-progress:           Marquage de '{0}' comme étant vérifiée...

protect-done:              Niveau de protection changé pour '{0}'
protect-fail:              Le niveau de protection n'a pas été changé pour '{0}'
protect-progress:          Changement du niveau de protection pour '{0}'...

protectlog-fail:           Failed to retrieve protection log for '{0}'
protectlog-none:           No protection log for '{0}'
protectlog-progress:       Retrieving protection log for '{0}'...

purge-done:                '{0}' a été purgé
purge-fail:                Échec lors de la purgation de '{0}'
purge-progress:            Purgation de '{0}'...

queue-refresh-fail:        Error refreshing queue '{0}'

report-duplicate:          L'utilisateur a déjà été signalé
report-fail:               '{0}' n'a pas été signalé
report-progress:           Signalement de '{0}'...

saveuserconfig-done:       Updated user configuration page
saveuserconfig-fail:       Did not update user configuration page
saveuserconfig-progress:   Updating user configuration page...

loadglobalconfig-fail:     Failed to load global configuration page
loadprojectconfig-fail:    Failed to load project configuration page
loaduserconfig-fail:       Failed to load user configuration page

reqprotection-badformat:   Format of request page unknown
reqprotection-duplicate:   Protection has already been requested
reqprotection-fail:        Did not request protection of '{0}'
reqprotection-progress:    Requesting protection of '{0}'...

revert-cannotundo:         Cannot undo due to conflicting intermediate edits
revert-conflict:           The page was edited by ignored user '{0}'
revert-fail:               Did not revert '{0}'
revert-nochange:           The content of the target revision is identical to that of the current revision
revert-nootheruser:        No other user has edited the page
revert-progress:           Reverting '{0}'...

tag-alreadytagged:         La page n'a pas été identifiée
tag-deleted:               La page a été supprimée
tag-fail:                  '{0}' n'a pas été identifié
tag-progress:              Identification de '{0}'...

sight-done:                Marked revision {0} of '{1}' as sighted
sight-fail:                Failed to sight revision {0} of '{1}'
sight-progress:            Marking revision {0} of '{1}' as sighted

speedy-fail:               Did not tag '{0}' for speedy deletion
speedy-progress:           Tagging '{0}' for speedy deletion...

warnlog-fail:              Failed to retrieve warning log for '{0}'
warnlog-none:              '{0}' has not been warned
warnlog-progress:          Retrieving warning log for '{0}'...

unwatch-done:              Removed '{0}' from watchlist
unwatch-fail:              Failed to remove '{0}' from watchlist
unwatch-progress:          Removing '{0}' from watchlist...

usermessage-duplicate:     A message about the same thing was already present
usermessage-fail:          Did not message '{0}'
usermessage-progress:      Messaging '{0}'...

watch-done:                '{0}' a été ajouté à la liste de suivi
watch-fail:                Échec lors de l'ajout de '{0}' à la liste de suivi
watch-progress:            Ajout de '{0}' à la liste de suivi...

warn-alreadyfinal:         L'utilisateur a déjà reçu un avertissement final
warn-alreadyblocked:       L'utilisateur a déjà été bloqué
warn-alreadyreported:      L'utilisateur a déjà été signalé
warn-oldedit:              The user has not edited since their latest warning
warn-recent:               L'utilisateur a été avertit il y a moins de {0} secondes
warn-fail:                 '{0}' n'a pas été avertit
warn-progress:             Avertissement de '{0}'...
</pre>

=== API ===
<pre>
api-help:                  No parameters in API query
</pre>