<pre>
name:                      日本語
</pre>

=== General ===
<pre>
add:                       追加
apply:                     適用
cancel:                    キャンセル
clear:                     クリア
close:                     閉じる
continue:                  続ける
copy:                      コピー
delete:                    削除
error:                     エラー
exit:                      終了
minimizewindow:            最小化
no:                        いいえ
ok:                        OK
remove:                    除去
rename:                    改名
restorewindow:             復元
save:                      保存
selectfile:                参照...
yes:                       はい
</pre>

=== Edit types ===
<pre>
edittype-blocknote:        ブロック通知
edittype-deletenote:       削除依頼通知
edittype-deletetag:        削除依頼タグ貼り付け
edittype-deletereq:        その他の削除依頼編集
edittype-manual:           手動編集
edittype-message:          利用者へのメッセージ
edittype-note:             その他の通知
edittype-prodtag:          提案削除タグ貼り付け
edittype-protectreq:       保護依頼
edittype-report:           伝言板への報告
edittype-revert:           リバート
edittype-speedytag:        即時削除タグ
edittype-tag:              その他のタグ
edittype-warning:          警告
</pre>

=== About form ===
<pre>
about-contributors:        開発者:
</pre>

=== Block form ===
<pre>
block-title:               {0} をブロック
block-reason:              理由:
block-duration:            期間:
block-message:             会話ページのメッセージ:
block-anononly:            匿名ユーザーのみブロック
block-creation:            アカウント作成のブロック
block-autoblock:           自動ブロック有効
block-email:               メール送信をブロック
block-usertalk:            会話ページ
block-usercontribs:        投稿記録
block-blockloglabel:       ブロック・ログ:
block-warnloglabel:        警告:
block-sharedipwarning:     注意: {0} は共有/可変IP とタグ付けされています
block-sensitivewarning:    このIPアドレスは以下の理由で 'センシティブ' リストに入れられています:\n\n   {0}\n\nそれでも続けますか？
block-rangeblockwarning:   {0} はすでにレンジブロック {1} の影響を受けています。\nブロックするとレンジ・ブロックに重ねて二重で影響を与えます。実行しますか？
</pre>

=== Closing form ===
<pre>
closing-whitelist:         ホワイトリストを更新中...
closing-config:            設定サブページを更新中...
</pre>

=== Configuration form ===
<pre>
config-title:              オプション
config-rememberme:         ログイン・ユーザー名を記憶する
config-rememberpassword:   ログイン・パスワードを記憶する
config-autowhitelist:      自動で利用者をホワイトリストに入れる
config-openinbrowser:      ブラウザリンクを新しいウィンドウで開く
config-shownewedits:       ページで新しい編集が行われたら、自動で表示を切り替える
config-preloads:           差分の事前ロードを有効にする
config-ircmode:            最近の更新をIRCフィードから取得する
config-ircport:            IRCポート
config-difffontsize:       差分の文字サイズ
config-logfile:            ログファイル
config-viewlocalconfig:    ローカル設定のあるフォルダを開く
config-trayicon:           トレイ・アイコンを表示
config-startupmessage:     スタートアップ・メッセージを表示
config-showlog:            ログを表示
config-showqueue:          版キューを表示
config-rightalignqueue:    キューをウィンドウの右側に表示する
config-showtooltips:       メニューにツールチップを表示する
config-shownewmessages:    新着メッセージ・バー
config-shortcutlist:       キーボード・ショートカット
config-shortcutaction:     アクション
config-shortcut:           ショートカット
config-changeshortcut:     {0} のショートカットを変更する
config-noshortcut:         なし
config-defaults:           デフォルト
config-minor:              細部の編集
config-watchlist:          ウォッチリストに追加
config-defaultsummary:     手動編集のデフォルト要約
config-undosummary:        自編集をさし戻すときのデフォルト要約
config-confirmmultiple:    同一利用者による複数の版を一気に差し戻す時は確認する
config-confirmsame:        リバートを受けている利用者による版へ差し戻す時は確認する
config-confirmselfrevert:  自分の編集を差し戻す時は確認する (アンドゥの場合をのぞく)
config-confirmwarned:      警告を受けている利用者による版へ差し戻す時は確認する
config-confirmrange:       リバートを受けているIPと同じ(/16)範囲のIPによる版へ差し戻す時は確認する
config-confirmpage:        無視ページを差し戻す時は確認する
config-autoadvance:        リバートした後、キュー内の次の編集に移動する
config-userollback:        もし可能な場合、ロールバック機能を使用する
config-revertsummaries:    メニュー内で利用可能な要約
config-clearsummaries:     手入力された要約はセッションを越えて記憶されます; クリアするには右のボタンを押してください
config-reportlinkexamples: 報告に荒らし編集への差分リンクを含める
config-extendreports:      報告後に荒らし編集が行われたら報告内容を追加する
config-autoreportgroup:    自動報告
config-autoreport:         利用者に最終警告を行うか聞かれた時
config-reportnone:         何もしない
config-reportprompt:       報告するかどうか聞く
config-reportauto:         自動で報告する
config-templates:          利用者テンプレート・メッセージ
config-templatetext:       テキストを表示
config-template:           テンプレート
config-highlightgroup:     文法チェック色付け
config-useadminfunctions:  もし可能な場合、管理者権限関連の機能を使用する
config-promptforblock:     最終警告を行うときに、ブロックするかどうか聞く
config-blockreason:        デフォルトのブロック理由
config-blocktime:          デフォルトのブロック期間
config-blocktimeanon:      IP利用者
config-blocktimereg:       登録利用者
config-summaryprompt:      要約を入力
config-defaultsprompt:     デフォルト設定に戻しますか？
config-logbrowsetitle:     ログ・ファイルの場所
config-shortcutconflict:   ショートカット '{0}' は、既存のショートカット '{1}' とかぶっています。
</pre>

=== Delete form ===
<pre>
delete-title:              {0} を削除
delete-reason:             理由:
delete-deletionlog:        削除ログ:
</pre>

=== Edit form ===
<pre>
edit-title:                {0} を編集
edit-summary:              要約欄:
edit-minor:                細部の編集
edit-watch:                ウォッチリストに追加
edit-page:                 ページ
edit-edit:                 編集
edit-view:                 閲覧
edit-page-savetofile:      ファイルに保存...
edit-page-save:            保存
edit-page-cancel:          キャンセル
edit-edit-undo:            取り消し
edit-edit-redo:            やり直し
edit-edit-cut:             切り取り
edit-edit-copy:            コピー
edit-edit-paste:           貼りつけ
edit-edit-delete:          削除
edit-edit-selectall:       すべて選択
edit-edit-find:            検索
edit-view-syntax:          文法色付け
edit-matchcase:            大文字小文字を区別
edit-find:                 検索:
edit-replace:              置換:
edit-findnext:             次
edit-findprevious:         前
edit-replaceall:           すべて置換
edit-edittab:              編集
edit-previewtab:           プレビュー
edit-changestab:           変更
edit-searchnotfound:       フレーズが見つかりません
edit-searchwrapstart:      ページの末尾に到達しました, 先頭から続けます
edit-searchwrapend:        ページの先頭に到達しました, 末尾から続けます
</pre>

=== E-mail form ===
<pre>
email-title:               {0} にメールを送信
email-subject:             件名:
email-message:             本文:
email-ccme:                自分宛に控えを送信する
email-send:                送信
</pre>

=== IRC feed ===
<pre>
irc-connected:             IRCの最近の更新フィードへ接続しました。
irc-connecting:            IRCの最近の更新フィードへ接続しています。しばらくお待ちください....
irc-disconnected:          IRCの最近の更新フィードから切断されました。再接続しています....
irc-nochannel:             {0}のIRCチャンネルが見つかりません。より低速なAPIクエリを代わりに使用します
irc-error:                 IRCの最近の更新フィードに接続できませんでした。より低速なAPIクエリを代わりに使用します
</pre>

=== List form ===
<pre>
list-actions:              アクションとフィルター...
list-browsetitle:          テキスト・ファイルをリストに追加
list-combine:              足しあわせ
list-copyto:               コピー先:
list-count:                {0} アイテム
list-deleteconfirm:        リスト '{0}' を削除しますか？
list-duplicatename:        '{0}' という名前のリストはすでに存在します。別の名前を指定してください。
list-intersect:            共通部分
list-limit:                まで:
list-listempty:            リストにアイテムがありません\nソースを入力し、「追加」をクリックしてください
list-nolists:              リストがありません\n「追加」 をクリックして作成してください
list-query-cancelled:      キャンセルしました.
list-query-fail:           クエリが失敗しました。
list-query-noresults:      クエリの結果がゼロでした。
list-query-progress:       クエリを実行しています...
list-query-results:        {0} 個の結果が得られました。
list-renameprompt:         新しい名前を入力:
list-replace:              置換
list-savefailed:           リストを保存できません:
list-savetitle:            リストを保存
list-sourcetype:           ソースのタイプ:
list-start:                から:
list-stop:                 停止
list-title:                リスト作成
</pre>

=== Login ===
<pre>
login-language:            言語:
login-project:             プロジェクト:
login-username:            利用者名:
login-password:            パスワード:
login-proxygroup:          プロキシ設定
login-proxy:               プロキシ・サーバーを使用する
login-proxyaddress:        アドレス:
login-proxyport:           ポート:
login-proxydomain:         ドメイン:
login-start:               ログイン
login-translate:           翻訳
login-captchatitle:        ログインにキャプチャが必要です

login-progress-start:      ログインしています...
login-progress-language:   メッセージ・ファイルを更新中...
login-progress-global:     グローバル設定をチェック中...
login-progress-config:     設定ページをチェック中...
login-progress-userlist:   ユーザーリストをチェック中...
login-progress-whitelist:  ユーザーホワイトリストを取得中...

login-error-admin:         このプロジェクトでハグルを使用するには管理者権限が必要です。
login-error-age:           このプロジェクトでハグルを使用するにはアカウント作成後 {0} 日以上が経過している必要があります。
login-error-alldisabled:   現在すべてのプロジェクトでハグルの使用ができません。
login-error-approval:      このプロジェクトでハグルを使用するには承認が必要です。
login-error-autoconfirmed: このプロジェクトでハグルを使用するには自動承認アカウントである必要があります。
login-error-cancelled:     キャンセルしました.
login-error-captcha:       パスワードまたは確認コードが正しくありません。
login-error-config:        設定ページのロードに失敗しました。
login-error-count:         このプロジェクトでハグルを使用するには最低でも編集回数が {0} 回以上ある必要があります。
login-error-disabled:      あなたのアカウントはハグルを使用可能に設定していません。利用者設定ページを確認してください。
login-error-global:        グローバル設定ページのロードに失敗しました。
login-error-invalid:       利用者名が不正です
login-error-language:      メッセージ・ファイルのロードに失敗しました。
login-error-nocaptcha:     キャプチャに解答できませんでした。
login-error-noconfig:      このプロジェクトにはハグルの設定ページがありません。
login-error-nouser:        その名前のアカウントは存在しません。
login-error-password:      パスワードが不正です
login-error-projdisabled:  現在このプロジェクトでハグルは使用できません。
login-error-rollback:      このプロジェクトでハグルを使用するにはロールバック権限が必要です。
login-error-unknown:       ログインできません。
login-error-userlist:      利用者リストのロードに失敗しました。
login-error-version:       このバージョンは古いバージョンです。最新版にアップデートしてください。
login-error-whitelist:     利用者ホワイトリストのロードに失敗しました。
</pre>

=== Main window ===
<pre>
main-page:                 ページ
main-user:                 利用者
main-contribs:             投稿記録
main-history:              履歴
main-new-messages:         会話ページに新しいメッセージがきています; 新着メッセージを見るには 「システム」から「新着メッセージを表示」を選択するか、キーボードの M を押してください。
main-system:               システム
main-system-messages:      新着メッセージを表示
main-system-reconnectirc:  IRCに再接続
main-system-savelog:       ログを保存...
main-system-lists:         リストを作成...
main-system-requests:      クエリーログ...
main-system-statistics:    統計...
main-system-showlog:       ログを表示
main-system-showqueue:     キューを表示
main-system-showtwoqueues: 二つのキューを表示
main-system-options:       オプション...
main-system-logout:        ログアウト
main-system-exit:          終了
main-queue:                キュー
main-queue-next:           次
main-queue-trim:           削る
main-queue-clear:          現在のキューをクリア
main-queue-count:          {0} アイテム
main-queue-query:          クエリを実行...
main-queue-reset:          リセット
main-queue-clearall:       すべてクリア
main-queue-options:        キューの設定...
main-goto:                 移動
main-goto-mytalk:          自分の会話ページ
main-goto-mycontribs:      自分の投稿記録
main-revision:             版
main-revision-view:        表示
main-revision-revert:      リバート
main-revision-previous:    前
main-revision-next:        次
main-revision-latest:      最新
main-revision-sight:       確認
main-page-switchtotalk:    ノートに切替
main-page-switchtosubject: 主ページに切替
main-page-switchtoarticle: 記事に切替
main-page-viewlatest:      最新の版を表示
main-page-history:         履歴を取得
main-page-historypage:     履歴ページを表示
main-page-edit:            編集
main-page-tag:             タグ
main-page-reqdeletion:     削除依頼
main-page-reqprotection:   保護依頼
main-page-watch:           ウォッチ
main-page-unwatch:         ウォッチリストからはずす
main-page-purge:           パージ
main-page-patrol:          パトロール済みにマーク
main-page-move:            移動...
main-page-protect:         保護...
main-page-delete:          削除...
main-user-info:            利用者情報を表示
main-user-ignore:          無視
main-user-unignore:        無視を取り消し
main-user-contribs:        投稿記録を取得
main-user-talk:            ノートを表示
main-user-message:         メッセージ...
main-user-email:           メール...
main-user-warn:            警告...
main-user-report:          報告
main-user-block:           ブロック...
main-browser:              ブラウザ
main-browser-newtab:       新しいタブ
main-browser-closetab:     タブを閉じる
main-browser-closeothers:  他のタブを閉じる
main-browser-back:         戻る
main-browser-forward:      進む
main-browser-open:         外部ブラウザで表示
main-browser-newedits:     ページの新しい編集を表示
main-browser-newcontribs:  利用者の新しい編集を表示
main-help:                 ヘルプ
main-help-documentation:   マニュアル
main-help-feedback:        フィードバック
main-help-about:           ハグルについて...
main-addqueue:             追加...
main-savelogtitle:         ログを保存
main-usermessageother:     その他のメッセージ...
main-advanced:             その他...
main-stats:                1分あたり {0} 編集、 1分あたり {1} リバート

main-tip-revertwarn:       この版をリバートして投稿者に警告を送る
main-tip-nextdiff:         キュー内の次の編集を表示
main-tip-revert:           この版をリバート
main-tip-template:         利用者にテンプレートメッセージを送る
main-tip-warn:             利用者に警告
main-tip-cancel:           保留中の操作をすべてキャンセル
main-tip-undo:             最近の操作を取り消す
main-tip-browserback:      戻る
main-tip-browserforward:   進む
main-tip-browseropen:      外部ブラウザで表示
main-tip-browsernewtab:    新しいタブ
main-tip-browserclosetab:  タブを閉じる
main-tip-history:          履歴を取得
main-tip-historyprev:      このページのひとつ前の差分を表示
main-tip-historynext:      このページのひとつ次の差分を表示
main-tip-historylast:      このページの現在の最新版を表示
main-tip-historydifftocur: このページと現在の最新版の差分を表示
main-tip-contribs:         利用者の投稿記録を取得
main-tip-contribsprev:     この利用者のひとつ前の投稿を表示
main-tip-contribsnext:     この利用者のひとつ次の投稿を表示
main-tip-contribslast:     この利用者の最新の投稿を表示
main-tip-pageview:         この版を表示
main-tip-pageedit:         このページを編集
main-tip-pagewatch:        このページをウォッチ
main-tip-pagetag:          このページにタグ貼り付け
main-tip-pagetagdelete:    このページに削除依頼タグを貼り付け
main-tip-pagedelete:       このページを削除
main-tip-userinfo:         利用者情報を表示
main-tip-usertalk:         利用者-会話ページを表示
main-tip-usermessage:      この利用者にメッセージを送る
main-tip-userignore:       この利用者の投稿をすべて無視
main-tip-userreport:       この利用者を報告
main-tip-userblock:        この利用者をブロック
</pre>

=== Message form ===
<pre>
message-title:             {0} にメッセージ
message-help:              節タイトルと要約の最低どちらかひとつを指定してください。要約が指定されていない場合、節タイトルが使用されます; 節タイトルが指定されていない場合、節分けは行ないません。
message-subject:           節タイトル:
message-message:           内容:
message-summary:           要約欄:
message-autosign:          署名を自動で付記
</pre>

=== Move form ===
<pre>
move-title:                {0} を移動
move-target:               移動先:
move-reason:               理由:
move-movetalk:             トークページの移動
</pre>

=== Prod form ===
<pre>
prod-title:                {0} を削除依頼
prod-reason:               理由:
</pre>

=== Protect form ===
<pre>
protect-title:             {0} を保護
protect-request-title:     {0} の保護依頼
protect-reason:            理由:
protect-expiry:            期間:
protect-log:               保護ログ:
protect-currentlevel:      現在の保護レベル:
protect-type:              保護のタイプ:
protect-none:              なし
protect-semiprotection:    半保護
protect-fullprotection:    全保護
protect-moveprotection:    移動保護
protect-noprotection:      保護されていません
</pre>

=== Queue form ===
<pre>
queue-title:               キュー
queue-queues:              キュー:
queue-typegroup:           キュー・タイプ
queue-listselector:        リスト:
queue-listbuilder:         リスト作成...
queue-sortorder:           順序:
queue-removeviewed:        確認した編集は除去する
queue-removeold:           同じページの古い編集は除去する
queue-removeafter:         古い編集は除去
queue-removeaftertime:     分
queue-preload:             このキューが選択されているとき版をプリロードする
queue-ignorepages:         無視ページリストにあるページの編集は無視する
queue-traynotification:    キューに版が追加されたらトレイ通知を表示
queue-diffsgroup:          差分
queue-nodiffs:             版を表示したときに差分をロードする
queue-preloaddiffs:        キューがアクティブな時に差分を事前ロードする
queue-alldiffs:            キュー内のすべての差分をロードする
queue-pagefiltersgroup:    ページ名フィルター
queue-pageregex:           ページ名が正規表現に一致:
queue-namespaces:          名前空間:
queue-applylabel:          既存のページリストにこのフィルターを適用する場合は、適用を押してください。
queue-editfiltersgroup:    編集フィルター
queue-userregex:           利用者名が正規表現に一致:
queue-summaryregex:        要約が正規表現に一致:
queue-filternewpage:       新規ページ
queue-filterownuserspace:  利用者のユーザーペース
queue-filteranonymous:     IP利用者
queue-filterignored:       無視利用者
queue-filterreverts:       リバート
queue-filternotifications: 通知
queue-filterwarnings:      警告
queue-filtertags:          タグ
queue-filterbot:           ボット編集
queue-filterassisted:      補助編集
queue-filterhuggle:        ハグル編集
queue-filterme:            自分の編集
queue-examplelabel1:       この属性が必要
queue-examplelabel2:       この属性があれば排除
queue-examplelabel3:       この属性をチェックしない
queue-usergroup:           これらの利用者の編集のみ表示
</pre>

=== Queue trim form ===
<pre>
queuetrim-title:           キューを削る
queuetrim-age:             次より古いキューはすべて捨てる
queuetrim-ageunit:         分
</pre>

=== Requests form ===
<pre>
requests-title:            クエリーログ
requests-cancelall:        キャンセル
requests-cancelled:        キャンセル
requests-inprogress:       進行中
requests-failed:           失敗
requests-completed:        完了
requests-time:             時間
requests-type:             タイプ
requests-query:            クエリー
</pre>

=== Report form ===
<pre>
report-title:              {0} を報告
report-reason:             理由:
report-message:            メッセージ:
report-log:                この利用者への警告:
</pre>

=== Revert form ===
<pre>
revert-title:              {0} をリバート
revert-summary:            リバート時の要約欄 (カラならデフォルト設定):
revert-currentonly:        選択した版だけをリバート
</pre>

=== Revert and warn form ===
<pre>
revertandwarn-title:       リバートして {0} に警告
</pre>

=== Reverting ===
<pre>
revert-confirm-ignored:    ホワイトリスト・ユーザー '{0}' の編集をリバートしますか？
revert-confirm-multiple:   '{0}' による複数の編集をリバートします。 実行しますか？
revert-confirm-range:      対象の版 {1} の投稿者は、現在の版 {0} の投稿者と同一レンジです。中の人は同一人物の可能性があります。差し戻し前に版の内容を確認することを推奨します。続けますか？
revert-confirm-page:       無視されたページ '{0}' を差し戻しますか？
revert-confirm-same:       このリバートは同じ利用者のすでにリバートされた版 {0} に差し戻すことになります。実行しますか？
revert-confirm-self:       自分で行った編集を差し戻すことになります。実行しますか？
revert-confirm-warned:     このリバートは {0} が編集した版に戻すことになります; この利用者は過去に警告を受けています。実行しますか？
revert-error-first:        この編集はページの最初の版です。リバートはできません。
revert-only:               この編集はこのページの唯一の編集です。
revert-creator:            最終編集はページ作成者 {0} による編集でした
revert-delete-instead:     代わりに記事を削除しますか？
revert-speedy-instead:     代わりに即時削除タグを貼り付けますか？
</pre>

=== Speedy form ===
<pre>
speedy-title:              {0} に即時削除タグ
speedy-reason:             理由:
speedy-parameters:         パラメータ:
speedy-notifycreator:      ページ作成者に通知
</pre>

=== Statistics form ===
<pre>
stats-title:               統計
stats-actions:             このセッションでの編集:
stats-session:             セッション経過時間: {0}
stats-edits:               編集
stats-assisted:            ツールによる編集
stats-huggle:              ハグルによる編集
stats-reverts:             リバート
stats-warnings:            警告
stats-reports:             報告
stats-tags:                タグ貼り
stats-notifications:       通知
stats-blocks:              ブロック
stats-deletes:             削除
stats-protections:         保護
stats-allusers:            全ユーザー
stats-me:                  自分
stats-ignored:             無視
stats-anon:                IP
stats-bots:                ボット
stats-other:               その他
</pre>

=== Tag form ===
<pre>
tag-title:                 {0} にタグを貼り付け
tag-tagselector:           タグ:
tag-tags:                  テキスト:
tag-summary:               要約:
tag-insertatend:           ページの最後尾に追加する
</pre>

=== Update form ===
<pre>
update-title:              新しいバージョンが利用できます
update-notification:       このバージョンのハグルはすでに古くなっています
update-required:           新しいバージョン {0} にアップデートする必要があります
update-optional:           新しいバージョン {0} へのアップデートを推奨します。将来的にアップデートがおそらく必要になります
update-prompt:             新しいバージョンをダウンロードしますか?
update-download:           アップデート
update-progress:           新しいバージョンをダウンロードしています...
update-error:              新しいバージョンのダウンロードに失敗しました
</pre>

=== User info form ===
<pre>
userinfo-title:            '{0}' の利用者情報
userinfo-anonymous:        IP利用者:
userinfo-ignored:          ホワイトリスト:
userinfo-edits:            編集回数:
userinfo-sessionedits:     このセッションの編集:
userinfo-sharedip:         共有/可変 IP:
userinfo-blocklog:         ブロック:
userinfo-warnlog:          警告:
</pre>

=== Warning form ===
<pre>
warning-title:             {0} に警告
warning-levelgroup:        警告レベル
warning-levelauto:         自動
warning-level1:            レベル 1
warning-level2:            レベル 2
warning-level3:            レベル 3
warning-level4:            レベル 4 (最後通告)
warning-warntype:          警告タイプ:
warning-warnlog:           この利用者への警告:
</pre>

=== XfD form ===
<pre>
xfd-title:                 {0} を削除依頼する
xfd-category:              カテゴリ:
xfd-nominationtype:        依頼タイプ:
xfd-notify:                作成者へ通知
xfd-reason:                理由:
</pre>

=== Web requests ===
<pre>
error-apidisabled:         メディアウィキAPIが使用できません
error-exception:           '{0}' の取得中にエラーが発生しました
error-fail:                '{0}' が取得できませんでした
error-loggedout:           アカウントがログアウトしています。再ログインします...
error-noresponse:          反応がありません
error-pagemissing:         対象ページが存在しません
error-reloginfail:         再ログインに失敗しましたハグルを再起動してください
error-timeout:             リクエストがタイムアウトしました
error-unknown:             未知のエラー

retrying:                  リトライしています...

block-done:                '{0}' をブロックしました
block-fail:                '{0}' をブロックしませんでした
block-progress:            '{0}' をブロックしています...

blocklog-fail:             '{0}' のブロック・ログの取得に失敗しました
blocklog-none:             '{0}' にブロック・ログがありません
blocklog-progress:         '{0}' のブロック・ログを取得しています...

blocknotify-fail:          '{0}' へのブロック通知に失敗しました
blocknotify-progress:      '{0}' にブロック通知を行っています...

delete-done:               '{0}' を削除しました
delete-fail:               '{0}' の削除に失敗しました
delete-progress:           '{0}' を削除しています...

deletelog-fail:            '{0}' の削除ログの取得に失敗しました
deletelog-none:            '{0}' に削除ログはありません
deletelog-progress:        '{0}' の削除ログを取得しています...

diff-deleted:              この版は削除されています
diff-fail:                 '{0}' の差分の取得に失敗しました

reqdelete-duplicate:       このページはすでにタグが貼られています
reqdelete-tagfail:         '{0}' への削除依頼タグの貼り付けに失敗しました
reqdelete-redirectfail:    このページはリダイレクトです。リダイレクトの削除依頼は定義されていません
reqdelete-tagprogress:     '{0}' に削除依頼タグを貼り付けています...

reqdelete-subpageprogress: '{0}' の削除依頼サブページを作成しています...
reqdelete-subpagefail:     '{0}' の削除依頼サブページが作成できませんでした
reqdelete-logprogress:     '{0}' の削除依頼を依頼ページに追加しています...
reqdelete-logfail:         '{0}' の削除依頼を依頼ページに追加できませんでした

edit-fail:                 '{0}' を編集できませんでした
edit-progress:             '{0}' を編集中...

email-done:                '{0}' にメールを送信しました
email-fail:                '{0}' にメールを送信できませんでした
email-progress:            '{0}' にメールを送信しています...

history-fail:              '{0}' の履歴取得に失敗しました
history-progress:          '{0}' ({1}) の履歴を取得しています...

move-done:                 '{0}' を '{1}' に移動しました
move-fail:                 '{0}' を '{1}' に移動できませんでした
move-progress:             '{0}' を '{1}' に移動しています...

notify-fail:               '{0}' の作成者へ通知できませんでした
notify-unknowncreator:     ページの作成者を同定できませんでした

patrol-duplicate:          このページはすでにパトロール済みにマークされています
patrol-done:               '{0}' をパトロール済みにマークしました
patrol-fail:               '{0}' をパトロール済みにマークできませんでした
patrol-notfound:           最近の更新IDが見つかりませんでした。ページが古すぎます
patrol-progress:           '{0}' をパトロール済みにマークしています...

protect-done:              '{0}' の保護レベルを変更しました
protect-fail:              '{0}' の保護レベルを変更できませんでした
protect-progress:          '{0}' の保護レベルを変更しています...

protectlog-fail:           '{0}' の保護ログが取得できませんでした
protectlog-none:           '{0}' に保護ログはありません
protectlog-progress:       '{0}' の保護ログを取得しています...

purge-done:                '{0}' をパージしました
purge-fail:                '{0}' のパージに失敗しました
purge-progress:            '{0}' をパージしています

queue-refresh-fail:        キュー '{0}' の更新時にエラーが発生しました

report-duplicate:          この利用者はすでに報告されています
report-fail:               '{0}' の報告に失敗しました
report-progress:           '{0}' を報告しています...

saveuserconfig-done:       利用者設定ページを更新しました
saveuserconfig-fail:       利用者設定ページを更新できませんでした
saveuserconfig-progress:   利用者設定ページを更新しています...

loadglobalconfig-fail:     グローバル設定ページのロードに失敗しました
loadprojectconfig-fail:    プロジェクト設定ページのロードに失敗しました
loaduserconfig-fail:       利用者設定ページのロードに失敗しました

reqprotection-badformat:   保護依頼ページが未知のフォーマットです
reqprotection-duplicate:   すでに保護依頼されています
reqprotection-fail:        '{0}' の保護依頼に失敗しました
reqprotection-progress:    '{0}' を保護依頼しています...

revert-cannotundo:         他の編集と競合したため、取り消しできませんでした
revert-conflict:           ページが無視利用者 '{0}' によって編集されました
revert-fail:               '{0}' をリバートできませんでした
revert-nochange:           戻し先の版の内容が、最新版の内容と同じです
revert-nootheruser:        他の利用者はこのページを編集していません
revert-progress:           '{0}' をリバートしています...

tag-alreadytagged:         このページはすでにタグが貼られています
tag-deleted:               このページはすでに削除されています
tag-fail:                  '{0}' にタグ貼り付けるのに失敗しました
tag-progress:              '{0}' にタグを貼り付けています...

sight-done:                '{1}' の {0} 版を確認済みにマークしました
sight-fail:                '{1}' の {0} 版を確認済みにマークできませんでした
sight-progress:            '{1}' の {0} 版を確認済みにマークしています

speedy-fail:               '{0}' への即時削除タグ貼り付けに失敗しました
speedy-progress:           '{0}' に即時削除タグを貼り付けています...

warnlog-fail:              '{0}' の警告履歴が取得できませんでした
warnlog-none:              '{0}' は警告を受けていません
warnlog-progress:          '{0}' の警告履歴を取得しています...

unwatch-done:              '{0}' をウォッチリストからはずしました
unwatch-fail:              '{0}' をウォッチリストからはずせませんでした
unwatch-progress:          '{0}' をウォッチリストからはずしています...

usermessage-duplicate:     同じ内容のメッセージがすでに存在しています
usermessage-fail:          '{0}' へのメッセージに失敗しました
usermessage-progress:      '{0}' にメッセージしています...

watch-done:                '{0}' をウォッチリストに追加しました
watch-fail:                '{0}' をウォッチリストに追加できませんでした
watch-progress:            '{0}' をウォッチリストに追加しています...

warn-alreadyfinal:         この利用者はすでに最終警告を受けています
warn-alreadyblocked:       この利用者はすでにブロックされています
warn-alreadyreported:      この利用者はすでに報告されています
warn-oldedit:              この利用者は最後の警告以降、編集を行っていません
warn-recent:               この利用者は {0} 秒以内に警告を受けています
warn-fail:                 '{0}' への警告に失敗しました
warn-progress:             '{0}' に警告を行っています...
</pre>

=== API ===
<pre>
api-help:                  APIクエリーのパラメータがありません
</pre>