<pre>
name:                       मराठी
</pre>

=== General ===
<pre>
add:                       Add
apply:                     Apply
cancel:                    Cancel
clear:                     खोडा
close:                     बंद
continue:                  Continue
copy:                      Copy
delete:                    काढून टाका 
error:                     अडथळा
exit:                      बाहेर जा
minimizewindow:            Minimize
no:                        नाही 
ok:                        ठीक आहे.
remove:                    काढून टाका 
rename:                    नाव बदला 
restorewindow:             Restore
save:                      जतन करा 
selectfile:                Browse...
yes:                       हो 
</pre>

=== Edit types ===
<pre>
edittype-blocknote:        Block notifications
edittype-deletenote:       Deletion चर्चा notifications
edittype-deletetag:        Deletion चर्चा tags
edittype-deletereq:        इतर deletion चर्चा संपादन
edittype-manual:           Manual संपादन
edittype-message:          सदस्य messages
edittype-note:             इतर notifications
edittype-prodtag:          Proposed deletion tags
edittype-protectreq:       सुरक्षा विनंती
edittype-report:           Reports
edittype-revert:           Reverts
edittype-speedytag:        Speedy deletion tags
edittype-tag:              इतर tags
edittype-warning:          सूचना
</pre>

=== About form ===
<pre>
about-contributors:        सहभागी:
</pre>

=== Block form ===
<pre>
block-title:               Block {0}
block-reason:              कारण:
block-duration:            कालावधी:
block-message:             Talk page message:
block-anononly:            Block anonymous users only
block-creation:            Block account creation
block-autoblock:           Enable autoblocks
block-email:               Block e-mail
block-usertalk:            Talk
block-usercontribs:        Contribs
block-blockloglabel:       Block log:
block-warnloglabel:        सूचना:
block-sharedipwarning:     Note: {0} is tagged as a shared or dynamic IP address.
block-sensitivewarning:    This IP address is listed as 'sensitive' for the following reason:\n\n   {0}\n\nContinue anyway?
block-rangeblockwarning:   {0} is already affected by a rangeblock on {1}.\nThis block will override the effect of the rangeblock. Continue?
</pre>