<pre>
name:                      ଓଡ଼ିଆ
</pre>

=== General ===
<pre>
add:                       ମିଶାଇବେ
apply:                     ବ୍ୟବହାର କରିବେ
cancel:                    ନାକଚ କରିବେ
clear:                     ଲିଭାଇ ଦେବେ
close:                     ବନ୍ଦ କରିବେ
continue:                  ଚାଲୁରଖିବେ
copy:                      ନକଲ କରିବେ
delete:                    ଲିଭାଇଦେବେ
error:                     ଭୁଲ
exit:                      ବାହାରିବେ
minimizewindow:            ଛୋଟ କରିବେ
no:                        ନାଁ
ok:                        ଠିକ ଅଛି
remove:                    ହଟାଇବେ
rename:                    ଆଉଥରେ ନାଆଁ ଦେବେ
restorewindow:             ଆଗକୁ ଫେରାଇନେବେ
save:                      ସାଇତିବେ
selectfile:                ଖୋଜିବେ...
yes:                       ହଁ
agf:                       କାରଣ ସହିତ ଭଲ ବଦଳକୁ ଫେରାଇନେବେ
import:                    ବିଶ୍ଵସ୍ତରୀୟ କନଫେରେନ୍ସରୁ ଫେରାଇବେ
</pre>

=== Edit types ===
<pre>
edittype-blocknote:        ସୂଚନାଗୁଡିକୁ ରଦ୍ଦ କରନ୍ତୁ
edittype-deletenote:       Deletion request notifications
edittype-deletetag:        Deletion discussion tags
edittype-deletereq:        Other deletion discussion edits
edittype-manual:           Manual edits
edittype-message:          User messages
edittype-note:             Other notifications
edittype-prodtag:          Proposed deletion tags
edittype-protectreq:       Protection requests
edittype-report:           ରିପୋର୍ଟଗୁଡ଼ିକ
edittype-revert:           ପଛକୁ ଫେରନ୍ତୁ
edittype-speedytag:        Speedy deletion tags
edittype-tag:              Other tags
edittype-warning:          Warnings
</pre>

=== About form ===
<pre>
about-contributors:        Developers:
</pre>

=== Block form ===
<pre>
block-title:               Block {0}
block-reason:              Reason:
block-duration:            Duration:
block-message:             Talk page message:
block-anononly:            Block anonymous users only
block-creation:            Block account creation
block-autoblock:           Enable autoblocks
block-email:               Block e-mail
block-usertalk:            Talk
block-usercontribs:        Contribs
block-blockloglabel:       Block log:
block-warnloglabel:        Warnings:
block-sharedipwarning:     Note: {0} is tagged as a shared or dynamic IP address.
block-sensitivewarning:    This IP address is listed as 'sensitive' for the following reason:\n\n   {0}\n\nContinue anyway?
block-rangeblockwarning:   {0} is already affected by a rangeblock on {1}.\nThis block will override the effect of the rangeblock. Continue?
</pre>

=== Closing form ===
<pre>
closing-whitelist:         Updating user whitelist...
closing-config:            Updating configuration subpage...
</pre>

=== Configuration form ===
<pre>
config-summ:               Custom revert summaries for templates
config-title:              ବିକଳ୍ପମାନ
config-rememberme:         ମୋ ବ୍ୟବହାରକାରୀ ନାମ ମନେ ରଖିବେ
config-rememberpassword:   ମୋ ପାସୱାର୍ଡ ମନେ ରଖିବେ
config-autowhitelist:      Automatically whitelist users
config-openinbrowser:      Open browser links in new browser window
config-shownewedits:       Show new edits to the selected page as they are made
config-preloads:           Enable preloading of diffs
config-ircmode:            Use IRC feed for recent changes if possible
config-ircport:            ଆଇଆରସି ପୋର୍ଟ
config-difffontsize:       ଅଲଗା ଫଣ୍ଟ ଆକାର
config-logfile:            ଲଗ ଫାଇଲ
config-viewlocalconfig:    ସ୍ଥାନୀୟ ସଂରଚନା ଫୋଲ୍ଡର ଦେଖିବେ
config-trayicon:           ଟ୍ରେ ଆଇକନ ଦେଖାଇବେ
config-startupmessage:     ଆରମ୍ଭ ସନ୍ଦେଶ ଦେଖାଇବେ
config-showlog:            ଲଗ ଦେଖାଇବେ
config-showqueue:          ସଂଶୋଧନ ଧାଡ଼ି ଦେଖାଇବେ
config-rightalignqueue:    ଉଇଣ୍ଡୋର ଡାହାଣପଟରେ ଧାଡ଼ି ଦେଖାଇବେ
config-showtooltips:       ମେନୁରେ ଟୁଲ ଟିପ୍ସ ଦେଖାଇବେ
config-shownewmessages:    ନୂଆ ସନ୍ଦେଶ ପଟିଟି ଦେଖାଇବେ
config-shortcutlist:       କିବୋର୍ଡ ସର୍ଟକଟମାନ
config-shortcutaction:     କାମ
config-shortcut:           ସର୍ଟକଟ
config-changeshortcut:     {0} ପାଇଁ ସର୍ଟକଟ ବଦଳାଇବେ
config-noshortcut:         None
config-defaults:           Defaults
config-minor:              Mark as minor
config-watchlist:          Add to watchlist
config-defaultsummary:     Default summary for manual edits
config-undosummary:        Summary when undoing own edits
config-confirmmultiple:    Confirm multiple reversions of an edit by the same user
config-confirmsame:        Confirm reversion to an edit by the user being reverted
config-confirmselfrevert:  Confirm reversion of own edits (except undo)
config-confirmwarned:      Confirm reversion to an edit by a warned user
config-confirmrange:       Confirm reversion to edit by an anonymous user in the same /16 range as the user being reverted
config-confirmpage:        Confirm reversion of ignored pages
config-autoadvance:        After reverting, move to next edit in the queue
config-userollback:        Use rollback if available
config-revertsummaries:    Revert summaries available in menu
config-clearsummaries:     Summaries entered manually are remembered across sessions; click to clear these
config-reportlinkexamples: Include links to instances of vandalism in reports
config-extendreports:      Extend reports after additional vandalism
config-autoreportgroup:    Auto-report
config-autoreport:         When asked to warn a user with a final warning
config-reportnone:         କିଛି କରନ୍ତୁ ନାହିଁ
config-reportprompt:       Prompt for report
config-reportauto:         Issue report automatically
config-templates:          User template messages
config-templatetext:       ଲେଖା ଦେଖାଇବେ
config-template:           ଟେମ୍ପଲେଟ
config-highlightgroup:     Syntax highlight colors
config-useadminfunctions:  Use administrator functions if available
config-promptforblock:     Prompt for block if asked to warn a user with a final warning
config-blockreason:        Default block reason
config-blocktime:          Default block duration for
config-blocktimeanon:      anonymous users
config-blocktimereg:       ଖାତା ଖୋଲିଥିବା ବ୍ୟବହାରକାରୀ
config-summaryprompt:      ସାରାଂଶ ଲେଖନ୍ତୁ
config-defaultsprompt:     Restore defaults?
config-logbrowsetitle:     ଲଗ ଫାଇଲ Log file location
config-shortcutconflict:   Shortcut '{0}' conflicts with the existing shortcut for '{1}'.
</pre>

=== Delete form ===
<pre>
delete-title:              ଲିଭାଇଦେବେ {0}
delete-reason:             କାରଣ:
delete-deletionlog:        ଲିଭାଇବା ଲଗ:
delete-rem-talk:           ଯୋଡିଥିବା ଆଲୋଚନା ଲିଭାଇବେ
delete-notify:             ନିର୍ମାତାଙ୍କୁ ସୂଚନା ଦେବେ
</pre>

=== Edit form ===
<pre>
edit-title:                ବଦଳାନ୍ତୁ {0}
edit-summary:              ସାରାଂଶ:
edit-minor:                ଛୋଟ ବଦଳ
edit-watch:                ପୃଷ୍ଠା ଉପରେ ନଜର ରଖନ୍ତୁ 
edit-page:                 ପୃଷ୍ଠା
edit-edit:                 ବଦଳ
edit-view:                 ଦେଖନ୍ତୁ
edit-page-savetofile:      ଫାଇଲକୁ... ସାଇତିବେ
edit-page-save:            ସାଇତିବେ
edit-page-cancel:          ବାତିଲ
edit-edit-undo:            ପଛକୁ ଫେରନ୍ତୁ
edit-edit-redo:            ପୁଣି ଥରେ କରନ୍ତୁ
edit-edit-cut:             କାଟିବେ
edit-edit-copy:            ନକଲ କରନ୍ତୁ
edit-edit-paste:           ଜୋଡନ୍ତୁ
edit-edit-delete:          ମିଟାନ୍ତୁ
edit-edit-selectall:       ସବୁ ସିଲେକ୍ଟ କରନ୍ତୁ
edit-edit-find:            ଖୋଜନ୍ତୁ
edit-view-syntax:          ବାକ୍ୟଗୁଡିକୁ ରଙ୍ଗ କରନ୍ତୁ
edit-matchcase:            କେସ ମିଳାନ୍ତୁ
edit-find:                 ଖୋଜନ୍ତୁ:
edit-replace:              ପୁଣି ଥରେ ସ୍ଥାପନ କରନ୍ତୁ:
edit-findnext:             ଆଗାମୀ
edit-findprevious:         ପୂର୍ବ ଅବସ୍ଥା ପାଆନ୍ତୁ
edit-replaceall:           ପୁଣି ଥରେ ସବୁ ସ୍ଥାପନ କରନ୍ତୁ
edit-edittab:              ବଦଳାନ୍ତୁ
edit-previewtab:           ଦେଖଣା
edit-changestab:           ପରିବର୍ତନ
edit-searchnotfound:       ଖୋଜିବାରୁ କିଛି ମିଳିଲାନି
edit-searchwrapstart:      ପୃଷ୍ଠାର ଶେଷରେ ପହଞ୍ଚିଲେ, ଆରମ୍ଭରୁ ଚାଲୁ ରଖନ୍ତୁ
edit-searchwrapend:        ପୃଷ୍ଠାର ଆରମ୍ଭରେ ପହଞ୍ଚିଲେ, ଶେଷରୁ ଚାଲୁ ରଖନ୍ତୁ
</pre>

=== E-mail form ===
<pre>
email-title:               ଇ-ମେଲ {0}
email-subject:             ବିଷୟବସ୍ତୁ:
email-message:             ସନ୍ଦେଶ:
email-ccme:                ଏକ ସନ୍ଦେଶର ନକଲ ମୋତେ ଇ-ମେଲ କରିବେ
email-send:                ପଠାଇବେ
</pre>

=== IRC feed ===
<pre>
irc-connected:             Connected to IRC recent changes feed
irc-connecting:            Attempting connection to IRC recent changes feed; this may take a few moments...
irc-disconnected:          Connection to IRC recent changes feed lost; reconnecting...
irc-nochannel:             IRC channel for {0} not found; using slower API queries instead
irc-error:                 Unable to connect to IRC recent changes feed. Using slower API queries instead
</pre>

=== List form ===
<pre>
list-actions:              Actions and Filters...
list-browsetitle:          ତାଲିକାରେ ଲେଖ ଫାଇଲ ଯୋଡ଼ିବେ
list-combine:              ମିଳାଇବେ
list-copyto:               Copy to:
list-count:                {0} items
list-deleteconfirm:        ହଟାଇବା ତାଲିକା '{0}'?
list-duplicatename:        A list with the name '{0}' already exists. Choose another name.
list-intersect:            ପ୍ରତିଛେଦନ
list-limit:                ପର୍ଯ୍ୟନ୍ତ:
list-listempty:            No items in list\nEnter a source and click "Add"
list-nolists:              No lists defined\nClick "Add" to create one
list-query-cancelled:      Cancelled.
list-query-fail:           Query failed.
list-query-noresults:      Query returned no results.
list-query-progress:       Running query...
list-query-results:        {0} results returned.
list-renameprompt:         ନୂଆ ନାମ ଦେବେ:
list-replace:              Replace
list-savefailed:           Unable to save list:
list-savetitle:            ତାଲିକା ସାଇତିବେ
list-sourcetype:           Source type:
list-start:                From:
list-stop:                 ବନ୍ଦ
list-title:                List Builder
</pre>

=== Login ===
<pre>
login-language:            ଭାଷା:
login-project:             ପ୍ରୋଜେକ୍ଟ:
login-username:            ବ୍ୟବହାରକାରୀଙ୍କ ନାମ:
login-password:            ପାସୱାର୍ଡ:
login-proxygroup:          ପ୍ରୋକ୍ସୀ ସେଟିଂସ
login-proxy:               ପ୍ରୋକ୍ସୀ ସର୍ଭର ବ୍ୟବହାର କରିବେ
login-proxyaddress:        ଠିକଣା:
login-proxyport:           ପୋର୍ଟ:
login-proxydomain:         ଡୋମେନ:
login-start:               ଲଗଇନ
login-translate:           ଅନୁବାଦ...
login-captchatitle:        କାପଚା ଲଗଇନ ପାଇଁ

login-progress-start:      ଲଗିଂ ଇନ... 
login-progress-language:   Updating message files...
login-progress-global:     Checking global configuration...
login-progress-config:     Checking configuration pages...
login-progress-userlist:   Checking user list...
login-progress-whitelist:  Retrieving user whitelist...

login-error-admin:         Use of Huggle on this project requires an administrator account.
login-error-age:           Use of Huggle on this project requires an account at least {0} days old.
login-error-alldisabled:   Huggle is currently disabled on all projects.
login-error-approval:      Use of Huggle on this project requires approval.
login-error-autoconfirmed: Use of Huggle on this project requires that your account is autoconfirmed.
login-error-cancelled:     Cancelled.
login-error-captcha:       Incorrect password or confirmation code.
login-error-config:        Failed to load configuration pages!
login-error-count:         Use of Huggle on this project requires at least {0} edits.
login-error-disabled:      Huggle is not enabled for your account, check user configuration page.
login-error-global:        Failed to load global configuration page.
login-error-invalid:       Invalid username.
login-error-language:      Failed to load message files.
login-error-nocaptcha:     Captcha not solved.
login-error-noconfig:      This project does not have a Huggle configuration page.
login-error-nouser:        User does not exist.
login-error-password:      Incorrect password.
login-error-projdisabled:  Huggle is currently disabled on this project.
login-error-rollback:      Use of Huggle on this project requires rollback.
login-error-unknown:       Unable to log in.
login-error-userlist:      Failed to load user list.
login-error-version:       Version is out of date. Update to the latest version.
login-error-whitelist:     Failed to load user whitelist.
</pre>

=== Main window ===
<pre>
main-page:                 ପୃଷ୍ଠା
main-user:                 ବ୍ୟବହାରକାରୀ
main-contribs:             ଯୋଗଦାନ
main-history:              ଇତିହାସ
main-new-messages:         ଆପଣଙ୍କ ପାଇଁ ନୂଆ ସନ୍ଦେଶ; ବ୍ୟବସ୍ଥା ବାଛନ୍ତୁ -> ନୂଆ ସନ୍ଦେଶ ଦେଖାଇବେ ବା ଦେଖିବା ପାଇଁ M ଦବାନ୍ତୁ.
main-system:               ବ୍ୟବସ୍ଥା
main-system-messages:      ନୂଆ ସନ୍ଦେଶ ଦେଖାଇବେ
main-system-reconnectirc:  ଆଇ ଆର ସି ଫୀଡ଼ରେ ପୁଣି ଥରେ ଯୋଡନ୍ତୁ
main-system-savelog:       ଲଗ ସାଇତିବେ...
main-system-lists:         ତାଲିକା ଗଠନକାରୀ...
main-system-requests:      ଅନୁରୋଧ...
main-system-statistics:    ସାଂଖିକ ବିବରଣୀ...
main-system-showlog:       ଲଗ ଦେଖାଇବେ
main-system-showqueue:     ଧାଡ଼ି ଦେଖାଇବେ
main-system-showtwoqueues: ଦୁଇଟି ଧାଡ଼ି ଦେଖାଇବେ
main-system-options:       ବିକଳ୍ପ...
main-system-logout:        ଲଗ ଆଉଟ
main-system-exit:          ବାହାରିବେ
main-queue:                ଧାଡ଼ି
main-queue-next:           ଆଗାମୀ
main-queue-trim:           Trim
main-queue-clear:          ବର୍ତ୍ତମାନ ସଫା କରିବେ
main-queue-count:          {0} ଗଣନ୍ତୁ
main-queue-query:          ପ୍ରଶ୍ନାବଳୀ ଚଲାନ୍ତୁ...
main-queue-reset:          ପୁଣି ଥରେ ସ୍ଥାପନ କରିବେ
main-queue-clearall:       ସବୁ ହଟାନ୍ତୁ
main-queue-options:        ଧାଡ଼ି ସଜାନ୍ତୁ...
main-goto:                 Go to
main-goto-mytalk:          ମୋ ଆଲୋଚନା ପୃଷ୍ଠା
main-goto-mycontribs:      ମୋ ଅବଦାନ
main-revision-decline:     ସଂଶୋଧନ ଅସ୍ଵୀକାର
main-revision:             ସଂଶୋଧନ
main-revision-view:        ଦେଖିବେ
main-revision-revert:      ପୂର୍ବାବସ୍ଥାକୁ ଫେରିବେ
main-revision-faith:       ଏ ଜି ଏଫ ପୂର୍ବବତ କରିବେ
main-revision-previous:    ପୂର୍ବବସ୍ଥାକୁ ଫେରିବେ
main-revision-next:        ପରବସ୍ଥାକୁ ଫେରିବେ
main-revision-latest:      ନବୀନତମ
main-revision-sight:       ଦୃଷ୍ଟି
main-page-switchtotalk:    ଆଲୋଚନା ପୃଷ୍ଠାକୁ ଯାଆନ୍ତୁ
main-page-switchtosubject: ବିଷୟ ପୃଷ୍ଠାକୁ ଯାଆନ୍ତୁ
main-page-switchtoarticle: ଲେଖ ପୃଷ୍ଠାକୁ ଯାଆନ୍ତୁ
main-page-viewlatest:      ନବୀନତମ ସଂଶୋଧନ ଦେଖିବେ
main-page-history:         ପୁଣି ଇତିହାସ ପାଇବେ
main-page-historypage:     ଇତିହାସ ପୃଷ୍ଠା ଦେଖିବେ
main-page-edit:            ବଦଳାଇବେ
main-page-tag:             ଟାଗ
main-page-reqdeletion:     ହଟାଇବା ପାଇଁ ଅନୁରୋଧ
main-page-reqprotection:   ସୁରକ୍ଷ୍ୟା ପାଇଁ ଅନୁରୋଧ
main-page-watch:           ଧ୍ୟାନ ଦେବେ
main-page-unwatch:         ଧ୍ୟାନ ହଟାଇବେ
main-page-purge:           କେସ ଖାଲି କରିବେ
main-page-patrol:          ପେଟ୍ରଲଡ଼ ଚିହ୍ନ ଦେବେ
main-page-move:            ଘୁଞ୍ଚାଇବେ...
main-page-protect:         ସୁରକ୍ଷ୍ୟା...
main-page-delete:          ହଟାଇବେ...
main-page-restore:         ଲେଖାର ଏହି ସଂସ୍କରଣକୁ ପୁଣି ସାଇତିବେ
main-user-info:            ବ୍ୟବହାରକାରୀଙ୍କ ଉପରେ କିଛି ଦେଖାଇବେ
main-user-ignore:          ଉପେକ୍ଷ୍ୟା କରିବେ
main-user-unignore:        Unignore
main-user-contribs:        Retrieve contributions
main-user-talk:            ଆଲୋଚନା ପୃଷ୍ଠା ଦେଖିବେ
main-user-message:         ସନ୍ଦେଶ...
main-user-email:           ଇ-ମେଲ...
main-user-warn:            ଚେତାବନୀ...
main-user-report:          ରିପୋର୍ଟ
main-user-block:           ଅବରୋଧ...
main-browser:              ବ୍ରାଉଜର
main-browser-newtab:       ନୂଆ ଟେବ
main-browser-closetab:     ଟେବ ବନ୍ଦ କରିବେ
main-browser-closeothers:  ଅଲଗା ଟେବ ବନ୍ଦ କରିବେ
main-browser-back:         Back
main-browser-forward:      Forward
main-browser-open:         View this in external browser
main-browser-newedits:     ପୃଷ୍ଠାରେ ନୂଆ ବଦଳ ଦେଖାଇବେ
main-browser-newcontribs:  Show new contributions by user
main-help:                 ସାହାଯ୍ୟ
main-help-documentation:   Documentation
main-help-feedback:        Feedback
main-help-about:           ହଗଲ ଉପରେ କିଛି...
main-addqueue:             ଯୋଡ଼ିବେ...
main-savelogtitle:         ଲଗ ସାଇତିବେ
main-usermessageother:     ଅନ୍ୟ ସନ୍ଦେଶ...
main-advanced:             Advanced...
main-stats:                {0} edits per minute, {1} reverts per minute

main-tip-revertwarn:       ଏହି ସଂସ୍କରଣକୁ ପଛକୁ କରିବେ, ଏବଂ ବ୍ୟବହାରକାରୀଙ୍କୁ ଚେତାବନୀ ଦେବେ
main-tip-nextdiff:         Show the next revision in the queue
main-tip-revert:           ଏହି ସଂସ୍କରଣକୁ ପଛକୁ କରିବେ
main-tip-template:         ବ୍ୟବହାରକାରୀଙ୍କୁ ଟେମ୍ପ୍ଲେଟ ସନ୍ଦେଶ ପଠାଇବେ
main-tip-warn:             ବ୍ୟବହାରକାରୀଙ୍କୁ ଚେତାବନୀ ଦେବେ
main-tip-cancel:           Cancel all pending actions
main-tip-undo:             Undo recent actions
main-tip-browserback:      Back
main-tip-browserforward:   Forward
main-tip-browseropen:      View this in external browser
main-tip-browsernewtab:    ନୂଆ ଟେବ
main-tip-browserclosetab:  ଟେବ ବନ୍ଦ କରିବେ
main-tip-history:          Retrieve page history
main-tip-historyprev:      Show previous revision to this page
main-tip-historynext:      Show next revision to this page
main-tip-historylast:      Show latest revision to this page
main-tip-historydifftocur: Show diff between this revision and the latest revision to this page
main-tip-contribs:         Retrieve user contributions
main-tip-contribsprev:     Show previous revision by this user
main-tip-contribsnext:     Show next revision by this user
main-tip-contribslast:     Show latest revision by this user
main-tip-pageview:         ଏହି ସଂସ୍କରଣ ଦେଖିବେ
main-tip-pageedit:         ଏହି ପୃଷ୍ଠାକୁ ବଦଳାଇବେ
main-tip-pagewatch:        ଏହି ପୃଷ୍ଠାରେ ନଜର ରଖିବେ
main-tip-pagetag:          ଏହି ପୃଷ୍ଠାକୁ ଟାଗ କରିବେ
main-tip-pagetagdelete:    ଏହି ପୃଷ୍ଠାକୁ ହଟାଇବା ପାଇଁ ଟାଗ କରିବେ
main-tip-pagedelete:       ଏହି ପୃଷ୍ଠାକୁ ହଟାଇବେ
main-tip-userinfo:         ବ୍ୟବହାରକାରୀଙ୍କ ଉପରେ କିଛି.. ଦେଖାଇବେ
main-tip-usertalk:         ବ୍ୟବହାରକାରୀଙ୍କ ଆଲୋଚନା ପୃଷ୍ଠା ଦେଖାଇବେ
main-tip-usermessage:      ବ୍ୟବହାରକାରୀଙ୍କୁ ସନ୍ଦେଶ ପଠାଇବେ
main-tip-userignore:       Ignore all contributions by this user
main-tip-userreport:       Report this user
main-tip-userblock:        Block this user
main-revision-acceptpend:   Accept this pending revision
</pre>

=== Message form ===
<pre>
message-title:             ସନ୍ଦେଶ {0}
message-help:              Specify one or both of Subject and Summary. If no summary is given, the subject will be used; if no subject is given, no header will be added.
message-subject:           ବିଷୟବସ୍ତୁ:
message-message:           ସନ୍ଦେଶ:
message-summary:           ସାରାଂଶ:
message-autosign:          ସ୍ଵଚାଳିତ ଭାବେ ଦସ୍ତଖତ ଯୋଡ଼ିବେ
</pre>

=== Move form ===
<pre>
move-title:                ଘୁଞ୍ଚାଇବେ {0}
move-target:               ଗନ୍ତବ୍ୟ ସ୍ଥାନ:
move-reason:               କାରଣ:
move-movetalk:             ଆଲୋଚନା ପୃଷ୍ଠା ଘୁଞ୍ଚାଇବେ
</pre>

=== Prod form ===
<pre>
prod-title:                {0} ମିଟାଇବା ପାଇଁ ଅନୁରୋଧ
prod-reason:               କାରଣ:
</pre>

=== Protect form ===
<pre>
protect-title:             ସୁରକ୍ଷ୍ୟା {0}
protect-request-title:     ସୁରକ୍ଷ୍ୟା {0} ପାଇଁ ନିବେଦନ
protect-reason:            କାରଣ:
protect-expiry:            ଶେଷ:
protect-log:               ସୁରକ୍ଷ୍ୟା ଲଗ:
protect-currentlevel:      ବର୍ତ୍ତମାନର ସୁରକ୍ଷ୍ୟା ସ୍ତର:
protect-type:              ସୁରକ୍ଷ୍ୟା ପ୍ରକାର:
protect-none:              କିଛି ନାହିଁ
protect-semiprotection:    ଅଧା ସୁରକ୍ଷ୍ୟା
protect-fullprotection:    ପୂର୍ଣ ସୁରକ୍ଷ୍ୟା
protect-moveprotection:    ସୁରକ୍ଷ୍ୟା ଘୁଞ୍ଚାନ୍ତୁ
</pre>

=== Queue form ===
<pre>
queue-title:               ଧାଡ଼ି
queue-queues:              ଧାଡ଼ି:
queue-typegroup:           ଧାଡ଼ି ପ୍ରକାର
queue-listselector:        ତାଲିକା:
queue-listbuilder:         ତାଲିକା ବିଲ୍ଡର...
queue-sortorder:           Sort order:
queue-removeviewed:        Remove edits when viewed
queue-removeold:           Remove old edits to the same page
queue-removeafter:         Remove edits after
queue-removeaftertime:     minutes
queue-preload:             Enable preloading of revisions when this queue is selected
queue-ignorepages:         Ignore edits to pages on the ignored pages list
queue-traynotification:    Show tray notification when a revision is added to this queue
queue-diffsgroup:          Diffs
queue-nodiffs:             Load diffs only when the revision is viewed
queue-preloaddiffs:        Preload diffs when queue is active
queue-alldiffs:            Load diffs for every revision in the queue
queue-pagefiltersgroup:    Page title filters
queue-pageregex:           Title matches regular expression:
queue-namespaces:          Namespaces:
queue-applylabel:          Click Apply to apply these filters to the existing page list.
queue-editfiltersgroup:    Edit filters
queue-userregex:           Username matches regular expression:
queue-summaryregex:        Summary matches regular expression:
queue-filternewpage:       ନୂଆ ପୃଷ୍ଠା
queue-filterownuserspace:  User's own userspace
queue-filteranonymous:     Anonymous user
queue-filterignored:       Ignored user
queue-filterreverts:       ପଛକୁ ଲେଉଟାଇବେ
queue-filternotifications: Notification
queue-filterwarnings:      ଚେତାବନୀ
queue-filtertags:          Tag
queue-filterbot:           ବଟ ବଦଳ
queue-filterassisted:      Assisted edit
queue-filterhuggle:        ହଗଲ ବଦଳ
queue-filterme:            ମୋ ବଦଳ
queue-examplelabel1:       Require this attribute
queue-examplelabel2:       Exclude this attribute
queue-examplelabel3:       Don't check this attribute
queue-usergroup:           Show only edits from these users
</pre>

=== Queue trim form ===
<pre>
queuetrim-title:           Trim queue
queuetrim-age:             Discard all queued revisions older than
queuetrim-ageunit:         minutes
</pre>

=== Requests form ===
<pre>
requests-title:            ଅନୁରୋଧ
requests-cancelall:        ସବୁ ବାତିଲ କରିବେ
requests-cancelled:        ବାତିଲ ହୋଇଯାଇଥିବା
requests-inprogress:       In progress
requests-failed:           Failed
requests-completed:        ପୁରା ହୋଇଥିବା
requests-time:             ସମୟ
requests-type:             ପ୍ରକାର
requests-query:            Query
</pre>

=== Report form ===
<pre>
report-title:              ରିପୋର୍ଟ {0}
report-reason:             କାରଣ:
report-message:            ସୂଚନା:
report-log:                ଏହି ବ୍ୟବହାରକରିଙ୍କ ପାଇଁ ଚେତାବନୀ:
</pre>

=== Revert form ===
<pre>
revert-title:              Revert {0}
revert-summary:            Revert summary (leave blank for default):
revert-currentonly:        Revert only the selected revision
</pre>

=== Revert and warn form ===
<pre>
revertandwarn-title:       ପଛକୁ ଲେଉଟାନ୍ତୁ ଏବଂ ଚେତାବନୀ ଦିଅନ୍ତୁ {0}
</pre>

=== Reverting ===
<pre>
revert-confirm-ignored:    Revert edit by whitelisted user '{0}'?
revert-confirm-multiple:   This will revert multiple edits by '{0}'. Continue?
revert-confirm-page:       Revert edit to ignored page '{0}'?
revert-confirm-range:      The author of the target revision, {1}, is in the same range as the author of the current revision, {0}, and may be the same person; ensure the target revision is correct before proceeding. Continue?
revert-confirm-same:       This will revert to another revision by the user that is being reverted, {0}. Continue?
revert-confirm-self:       This will revert your own edit. Continue?
revert-confirm-warned:     This will revert to a revision by {0}; this user has previously been warned. Continue?
revert-error-first:        Edit is the first edit to the page; unable to revert.
revert-only:               Edit is the only edit to the page.
revert-creator:            Last edit was made by page creator, {0}.
revert-delete-instead:     Delete page instead?
revert-speedy-instead:     Tag for speedy deletion instead?
</pre>

=== Speedy form ===
<pre>
speedy-title:              Speedy tag {0}
speedy-reason:             କାରଣ:
speedy-parameters:         Parameters:
speedy-notifycreator:      Notify page creator
</pre>

=== Statistics form ===
<pre>
stats-title:               ସାଂଖିକ ବିବରଣୀ
stats-actions:             ଏହି ଅଧିବେଶନର ଚାଲି ଚଳନ:
stats-session:             ଅଧିବେଶନ ସମୟ: {0}
stats-edits:               ବଦଳ
stats-assisted:            ସହାୟତା ବଦଳ
stats-huggle:              ହଗଲ ବଦଳ
stats-reverts:             ପଛକୁ ଫେରିବେ
stats-warnings:            ଚେତାବନୀ
stats-reports:             ରିପୋର୍ଟ
stats-tags:                ଟାଗ
stats-notifications:       ଅଧିସୂଚନା
stats-blocks:              ବାଧା
stats-deletes:             ହଟାଇବେ
stats-protections:         ସୁରକ୍ଷ୍ୟା
stats-allusers:            ସମସ୍ତ ବ୍ୟବହାରକାରୀ
stats-me:                  ମୁଁ
stats-ignored:             ଉପେକ୍ଷ୍ୟା
stats-anon:                ଅଜ୍ଞାନକୃତ
stats-bots:                ବଟ
stats-other:               ଅନ୍ୟ
</pre>

=== Tag form ===
<pre>
tag-title:                 ଟାଗ {0}
tag-tagselector:           ଟାଗ ଜୋଡନ୍ତୁ:
tag-tags:                  ଟାଗ(ମାନ):
tag-summary:               ସାରାଂଶ:
tag-insertatend:           ପୃଷ୍ଠାର ଶେଷରେ ସାମିଲ କରନ୍ତୁ
</pre>

=== Update form ===
<pre>
update-title:              New version available
update-notification:       This version of Huggle is out of date.
update-required:           You must update to the latest version, {0}.
update-optional:           Updating to the latest version, {0}, is recommended, and may be required in future.
update-prompt:             Download and run the latest version now?
update-download:           Update
update-progress:           Downloading new version...
update-error:              Failed to download new version
</pre>

=== User info form ===
<pre>
userinfo-title:            User information for '{0}'
userinfo-anonymous:        Anonymous:
userinfo-ignored:          Whitelisted:
userinfo-edits:            Number of edits:
userinfo-sessionedits:     Edits this session:
userinfo-sharedip:         Shared/dynamic IP:
userinfo-blocklog:         Blocks:
userinfo-warnlog:          Warnings:
</pre>

=== Warning form ===
<pre>
warning-title:             ଚେତାବନୀ {0}
warning-levelgroup:        ଚେତାବନୀ ସ୍ତର
warning-levelauto:         ସ୍ଵଚାଳିତ
warning-level1:            ସ୍ତର 1
warning-level2:            ସ୍ତର 2
warning-level3:            ସ୍ତର 3
warning-level4:            ସ୍ତର 4 (ଅନ୍ତିମ)
warning-warntype:          ଚେତାବନୀ ପ୍ରକାର:
warning-warnlog:           ଏହି ବ୍ୟବହାରକାରୀଙ୍କ ପାଇଁ ଚେତାବନୀ:
</pre>

=== XfD form ===
<pre>
xfd-title:                 Nominate {0} for deletion
xfd-category:              ଶ୍ରେଣୀ:
xfd-nominationtype:        Nomination type:
xfd-notify:                Notify creator
xfd-reason:                କାରଣ:
</pre>

=== Web requests ===
<pre>
error-apidisabled:         The MediaWiki API is disabled
error-exception:           Error retrieving '{0}'
error-fail:                Failed to retrieve '{0}'
error-loggedout:           Account has been logged out, logging back in...
error-noresponse:          No response
error-pagemissing:         The page does not exist
error-reloginfail:         Failed to log back in, try restarting Huggle
error-timeout:             Request timed out
error-unknown:             Unknown error

retrying:                  Retrying...

block-done:                Blocked '{0}'
block-fail:                Did not block '{0}'
block-progress:            Blocking '{0}'...

blocklog-fail:             Failed to retrieve block log for '{0}'
blocklog-none:             No block log for '{0}'
blocklog-progress:         Retrieving block log for '{0}'...

blocknotify-fail:          Did not notify '{0}' of block
blocknotify-progress:      Notifying '{0}' of block...

delete-done:               Deleted '{0}'
delete-fail:               Did not delete '{0}'
delete-progress:           Deleting '{0}'...

deletelog-fail:            Failed to retrieve deletion log for '{0}'
deletelog-none:            No deletion log for '{0}'
deletelog-progress:        Retrieving deletion log for '{0}'...

diff-deleted:              This revision has been deleted.
diff-fail:                 Failed to retrieve diff of '{0}'

reqdelete-duplicate:       The page is already tagged
reqdelete-tagfail:         Did not tag '{0}' for deletion discussion
reqdelete-redirectfail:    The page is a redirect and no redirect discussion process is defined
reqdelete-tagprogress:     Tagging '{0}' for deletion discussion...

reqdelete-subpageprogress: Creating deletion discussion subpage for '{0}'...
reqdelete-subpagefail:     Did not create deletion discussion subpage for '{0}'
reqdelete-logprogress:     Adding '{0}' to deletion discussion log...
reqdelete-logfail:         Did not add '{0}' to deletion discussion log

edit-fail:                 Did not edit '{0}'
edit-progress:             Editing '{0}'...

email-done:                Sent e-mail to '{0}'
email-fail:                Failed to send e-mail to '{0}'
email-progress:            Sending e-mail to '{0}'...

history-fail:              Failed to retrieve history of '{0}'
history-progress:          Retrieving history of '{0}' ({1})...

move-done:                 Moved '{0}' to '{1}'
move-fail:                 Did not move '{0}' to '{1}'
move-progress:             Moving '{0}' to '{1}'...

notify-fail:               Did not notify the creator of '{0}'
notify-unknowncreator:     Cannot find page creator

patrol-duplicate:          The page is already patrolled
patrol-done:               Marked '{0}' as patrolled
patrol-fail:               Did not mark '{0}' as patrolled
patrol-notfound:           Cannot find recent-changes id, page is too old
patrol-progress:           Marking '{0}' as patrolled...

protect-done:              Changed protection level for '{0}'
protect-fail:              Did not change protection level for '{0}'
protect-progress:          Changing protection level for '{0}'...

protectlog-fail:           Failed to retrieve protection log for '{0}'
protectlog-none:           No protection log for '{0}'
protectlog-progress:       Retrieving protection log for '{0}'...

purge-done:                Purged '{0}'
purge-fail:                Failed to purge '{0}'
purge-progress:            Purging '{0}'

queue-refresh-fail:        Error refreshing queue '{0}'

report-duplicate:          The user has already been reported
report-fail:               Did not report '{0}'
report-progress:           Reporting '{0}'...

saveuserconfig-done:       Updated user configuration page
saveuserconfig-fail:       Did not update user configuration page
saveuserconfig-progress:   Updating user configuration page...

loadglobalconfig-fail:     Failed to load global configuration page
loadprojectconfig-fail:    Failed to load project configuration page
loaduserconfig-fail:       Failed to load user configuration page

reqprotection-badformat:   Format of request page unknown
reqprotection-duplicate:   Protection has already been requested
reqprotection-fail:        Did not request protection of '{0}'
reqprotection-progress:    Requesting protection of '{0}'...

revert-cannotundo:         Cannot undo due to conflicting intermediate edits
revert-conflict:           The page was edited by ignored user '{0}'
revert-fail:               Did not revert '{0}'
revert-nochange:           The content of the target revision is identical to that of the current revision
revert-nootheruser:        No other user has edited the page
revert-progress:           Reverting '{0}'...

tag-alreadytagged:         The page has already been tagged
tag-deleted:               The page has been deleted
tag-fail:                  Did not tag '{0}'
tag-progress:              Tagging '{0}'...

sight-done:                Marked revision {0} of '{1}' as sighted
sight-fail:                Failed to sight revision {0} of '{1}'
sight-progress:            Marking revision {0} of '{1}' as sighted

speedy-fail:               Did not tag '{0}' for speedy deletion
speedy-progress:           Tagging '{0}' for speedy deletion...

warnlog-fail:              Failed to retrieve warning log for '{0}'
warnlog-none:              '{0}' has not been warned
warnlog-progress:          Retrieving warning log for '{0}'...

unwatch-done:              Removed '{0}' from watchlist
unwatch-fail:              Failed to remove '{0}' from watchlist
unwatch-progress:          Removing '{0}' from watchlist...

usermessage-duplicate:     A message about the same thing was already present
usermessage-fail:          Did not message '{0}'
usermessage-progress:      Messaging '{0}'...

watch-done:                Added '{0}' to watchlist
watch-fail:                Failed to add '{0}' to watchlist
watch-progress:            Adding '{0}' to watchlist...

warn-alreadyfinal:         The user already has a final warning
warn-alreadyblocked:       The user has already been blocked
warn-alreadyreported:      The user has already been reported
warn-oldedit:              The user has not edited since their latest warning
warn-recent:               The user was warned less than {0} seconds ago
warn-fail:                 Did not warn '{0}'
warn-progress:             Warning '{0}'...
</pre>

=== API ===
<pre>
api-help:                  No parameters in API query
</pre>