<pre>
name:                      Português
</pre>

=== General ===
<pre>
add:                       Adicionar
apply:                     Aplicar
cancel:                    Cancelar
clear:                     Apagar
close:                     Fechar
continue:                  Continuar
copy:                      Copiar
delete:                    Eliminar
error:                     Erro
exit:                      Sair
minimizewindow:            Minimizar
no:                        Não
ok:                        OK
remove:                    Remover
rename:                    Renomear
restorewindow:             Restaurar
save:                      Gravar
selectfile:                Selecionar...
yes:                       Sim
agf:                       Reverter como edição de boa fé com motivo personalizado
import:                    Importar da configuração global
</pre>

=== Edit types ===
<pre>
edittype-blocknote:        Notificações de bloqueio
edittype-deletenote:       Notificações de pedidos de eliminação
edittype-deletetag:        Marcações em discussões de propostas para eliminação
edittype-deletereq:        Outras edições em discussões de propostas para eliminação
edittype-manual:           Edições manuais
edittype-message:          Mensagens de usuário
edittype-note:             Outras notificações
edittype-prodtag:          Marcações de eliminação semirrápida
edittype-protectreq:       Pedidos de proteção
edittype-report:           Reportar a administradores
edittype-revert:           Reversões
edittype-speedytag:        Marcações de eliminação rápida
edittype-tag:              Outras marcações
edittype-warning:          Avisos
</pre>

=== About form ===
<pre>
about-contributors:        Colaboradores:
</pre>

=== Block form ===
<pre>
block-title:               Bloquear {0}
block-reason:              Razão:
block-duration:            Duração:
block-message:             Mensagem na página de discussão:
block-anononly:            Bloquear apenas anónimos
block-creation:            Bloquear criação de conta
block-autoblock:           Ativar autobloqueios
block-email:               Bloquear email
block-usertalk:            Disc
block-usercontribs:        Contribs
block-blockloglabel:       Relatório de bloqueios:
block-warnloglabel:        Avisos:
block-sharedipwarning:     Nota: {0} está marcado como sendo um IP partilhado.
block-sensitivewarning:    Este endereço IP está marcado como 'sensível' pela seguinte razão:\n\n   {0}\n\nContinuar?
block-rangeblockwarning:   {0} já é afetado por um bloqueio de gama em {1}.\nEste bloqueio substituirá o efeito do bloqueio de gama. Continuar?
</pre>

=== Closing form ===
<pre>
closing-whitelist:         Atualização automática da lista...
closing-config:            Atualização automática da configuração...
</pre>

=== Configuration form ===
<pre>
config-summ:               Sumários personalizados de reversão para predefinições
config-title:              Opções
config-rememberme:         Lembrar o meu nome de usuário
config-rememberpassword:   Lembrar a minha palavra-chave
config-autowhitelist:      Adicionar automaticamente usuários à lista branca
config-openinbrowser:      Abrir hiperligações numa nova janela do navegador externo
config-shownewedits:       Mostrar automaticamente novas edições na página caso elas ocorram
config-preloads:           Ativar pré-carregamento de difs
config-ircmode:            Usar se possível o feed IRC para as mudanças recentes
config-ircport:            Porta do IRC
config-difffontsize:       Tamanho da fonte
config-logfile:            Ficheiro de relatórios
config-viewlocalconfig:    Ver pasta de configuração local
config-trayicon:           Mostrar ícone na barra de tarefas do Windows
config-startupmessage:     Mostrar mensagem de inicialização do Huggle
config-showlog:            Mostrar relatório de ações do Huggle
config-showqueue:          Mostrar fila de edições a rever
config-rightalignqueue:    Deslocar fila de edições a rever para o lado direito
config-showtooltips:       Mostrar tooltips nos menus
config-shownewmessages:    Mostrar barra de novas mensagens caso editem a minha página de discussão
config-shortcutlist:       Teclas de atalhos
config-shortcutaction:     Ação
config-shortcut:           Atalho
config-changeshortcut:     Alterar atalho para {0}
config-noshortcut:         Nenhum
config-defaults:           Restaurar
config-minor:              Marcar como edição menor
config-watchlist:          Adicionar às páginas vigiadas
config-defaultsummary:     Sumário padrão para edições manuais
config-undosummary:        Sumário para edições minhas que eu cancelar
config-confirmmultiple:    Pedir confirmação ao reverter várias edições do mesmo usuário
config-confirmsame:        Pedir confirmação ao reverter para uma edição do mesmo usuário
config-confirmselfrevert:  Pedir confirmação ao reverter edições minhas (excluindo desfazer)
config-confirmwarned:      Pedir confirmação ao reverter para uma edição de um usuário com avisos
config-confirmrange:       Pedir confirmação ao reverter uma edição de um IP para outra de um IP da mesma gama /16
config-confirmpage:        Pedir confirmação ao reverter edições nas páginas ignoradas como a pág. de testes
config-autoadvance:        Após reverter, mostrar automaticamente a próxima edição a rever
config-userollback:        Usar rollback caso esteja disponível
config-revertsummaries:    Sumários de edição disponíveis no menu
config-clearsummaries:     Sumários introduzidos manualmente são memorizados entre sessões; clicar no botão ao lado para os apagar
config-reportlinkexamples: Incluir ligações para edições de vandalismo ao reportar vândalos aos administradores
config-extendreports:      Após vandalismo posterior acrescentar novas ligações na página de reportar vândalos
config-autoreportgroup:    Reportar automaticamente
config-autoreport:         Quando me for perguntado se quero dar um aviso final a um usuário
config-reportnone:         Não fazer nada
config-reportprompt:       Perguntar se quero reportar o vândalo
config-reportauto:         Reportar vândalo automaticamente
config-templates:          Mensagens para notificar usuários
config-templatetext:       Texto
config-template:           Predefinição
config-highlightgroup:     Cores de destaque da sintaxe
config-useadminfunctions:  Usar opções de administradores caso seja possível
config-promptforblock:     Perguntar se quero bloquear ao avisar pela última vez um usuário
config-blockreason:        Razão padrão do bloqueio 
config-blocktime:          Duração padrão do bloqueio para
config-blocktimeanon:      IP
config-blocktimereg:       usuários registados
config-summaryprompt:      Introduza o sumário
config-history:            Baixar todo o histórico de todos os artigos
config-defaultsprompt:     Restaurar padrão?
config-logbrowsetitle:     Localização do ficheiro de relatórios
config-shortcutconflict:   O atalho '{0}' é igual ao atalho de '{1}'.
</pre>

=== Delete form ===
<pre>
delete-title:              Eliminar {0}
delete-reason:             Razão:
delete-deletionlog:        Relatório de eliminações:
delete-rem-talk:           Eliminar discussão associada
delete-notify:             Notificar criador
</pre>

=== Edit form ===
<pre>
edit-title:                Editando {0}
edit-summary:              Sumário:
edit-minor:                Ed. menor
edit-watch:                Vigiar esta página
edit-page:                 Página
edit-edit:                 Editar
edit-view:                 Ver esta edição
edit-page-savetofile:      Gravar para o ficheiro...
edit-page-save:            Gravar
edit-page-cancel:          Cancelar
edit-edit-undo:            Desfazer
edit-edit-redo:            Refazer
edit-edit-cut:             Recortar
edit-edit-copy:            Copiar
edit-edit-paste:           Colar
edit-edit-delete:          Apagar
edit-edit-selectall:       Selecionar tudo
edit-edit-find:            Buscar
edit-view-syntax:          Cores de destaque da sintaxe
edit-matchcase:            Texto exato
edit-find:                 Buscar:
edit-replace:              Substituir por:
edit-findnext:             Seguinte
edit-findprevious:         Anterior
edit-replaceall:           Substituir tudo
edit-edittab:              Editar
edit-previewtab:           Prever
edit-changestab:           Alterações
edit-searchnotfound:       Sem resultados
edit-searchwrapstart:      Atingido o final da página, a continuar do início
edit-searchwrapend:        Atingido o início da página, a continuar do final
</pre>

=== E-mail form ===
<pre>
email-title:               Email {0}
email-subject:             Assunto:
email-message:             Mensagem:
email-ccme:                Enviar uma cópia deste email para a minha caixa de correio
email-send:                Enviar
</pre>

=== IRC feed ===
<pre>
irc-connected:             Ligado ao feed de IRC de mudanças recentes
irc-connecting:            A ligar ao feed IRC de mudanças recentes; aguarde um momento...
irc-disconnected:          Perdeu-se a ligação ao feed de IRC de mudanças recentes; a ligar...
irc-nochannel:             Não foi encontrado o canal IRC para {0}. A usar como alternativa os pedidos API apesar de serem lentos
irc-error:                 Não foi possível ligar ao feed de IRC de mudanças recentes. A usar como alternativa os pedidos API apesar de serem lentos
</pre>

=== List form ===
<pre>
list-actions:              Ações e filtros...
list-browsetitle:          Adicionar arquivo de texto à lista
list-combine:              Combinar
list-copyto:               Copiar para:
list-count:                {0} itens
list-deleteconfirm:        Eliminar a lista '{0}'?
list-duplicatename:        Já existe uma lista com o nome '{0}'. Escolha outro nome.
list-intersect:            Interseção
list-limit:                Até:
list-listempty:            A lista não tem intens\nEspecifique o "Tipo de fonte" e clique no botão "Adicionar"
list-nolists:              Não existem listas\nClique em "Adicionar" para criar uma
list-query-cancelled:      Cancelado.
list-query-fail:           O pedido falhou.
list-query-noresults:      O pedido não obteve resultados.
list-query-progress:       A fazer o pedido...
list-query-results:        {0} resultados recebidos.
list-renameprompt:         Introduza o novo nome:
list-replace:              Substituir
list-savefailed:           Não foi possível gravar a lista:
list-savetitle:            Gravar lista
list-sourcetype:           Tipo de fonte:
list-start:                De:
list-stop:                 Parar
list-title:                Construtor de listas
</pre>

=== Login ===
<pre>
login-language:            Língua:
login-project:             Projeto:
login-username:            Usuário:
login-password:            Palavra-passe:
login-proxygroup:          Definições de proxy
login-proxy:               Usar um servidor proxy
login-proxyaddress:        Endereço:
login-proxyport:           Porta:
login-proxydomain:         Domínio:
login-start:               Entrar
login-translate:           Traduzir...
login-captchatitle:        Captcha necessário para entrar na conta

login-progress-start:      A entrar na conta...
login-progress-language:   A atualizar os ficheiros de mensagens...
login-progress-global:     A verificar a configuração global...
login-progress-config:     A verificar a configuração...
login-progress-userlist:   A verificar a lista de usuários...
login-progress-whitelist:  A receber a lista branca de usuários...

login-error-admin:         Para usar o Huggle no projeto que escolheu é necessário ser administrador.
login-error-age:           Para usar o Huggle no projeto que escolheu é necessário ter uma conta de usuário criada à pelo menos {0} dias.
login-error-alldisabled:   O Huggle neste momento está bloqueado em todos os projetos. Provavelmente é uma medida temporária.
login-error-approval:      Para usar o Huggle no projeto que escolheu é necessária a aprovação prévia.
login-error-autoconfirmed: Para usar o Huggle no projeto que escolheu é necessário que a sua conta seja autoconfirmada.
login-error-cancelled:     Cancelado.
login-error-captcha:       Introduziu uma palavra-chave ou código de confirmação Captcha incorretos.
login-error-config:        Não foi possível carregar a página de configuração.
login-error-count:         Para usar o Huggle no projeto que escolheu são necessárias pelo menos {0} edições.
login-error-disabled:      O Huggle não está ativo na sua conta de usuário. Verifique a sua página de configuração pessoal.
login-error-global:        O Huggle não conseguiu carregar a página de configuração global.
login-error-invalid:       Introduziu um nome de usuário inválido.
login-error-language:      Falha ao carregar ficheiros de mensagens. 
login-error-nocaptcha:     Código de confirmação Captcha errado.
login-error-noconfig:      Este projeto não tem uma página de configuração do Huggle.
login-error-nouser:        A conta de usuário não existe.
login-error-password:      Palavra-chave errada.
login-error-projdisabled:  O Huggle neste momento está bloqueado no projeto que escolheu. Provavelmente é uma medida temporária.
login-error-rollback:      O Huggle necessita de privilégio de rollback no projecto que escolheu.
login-error-unknown:       Não foi possível entrar na conta de usuário.
login-error-userlist:      O Huggle não conseguiu obter a lista de usuários aprovados que o podem utilizar.
login-error-version:       Esta versão foi descontinuada. Por favor faça uma atualização para a última versão do Huggle.
login-error-whitelist:     Não foi possível carregar a lista branca de usuários.
</pre>

=== Main window ===
<pre>
main-page:                 Página
main-user:                 Usuário
main-contribs:             Contribs
main-history:              História
main-new-messages:         Tem novas mensagens; selecione Sistema ->Mostrar novas mensagens ou pressione a tecla M para as ver
main-system:               Sistema
main-system-messages:      Mostrar novas mensagens
main-system-reconnectirc:  Tornar a ligar ao feed de IRC
main-system-savelog:       Gravar relatório de ações...
main-system-lists:         Construtor de listas...
main-system-requests:      Pedidos...
main-system-statistics:    Estatísticas...
main-system-showlog:       Mostrar relatório
main-system-showqueue:     Mostrar fila de edições a rever
main-system-showtwoqueues: Mostrar duas filas de edições a rever
main-system-options:       Opções...
main-system-logout:        Sair da conta
main-system-exit:          Sair do Huggle
main-queue:                Fila de edições
main-queue-next:           Ver próxima edição a rever na fila
main-queue-trim:           Remover edições antigas da fila...
main-queue-clear:          Remover todas as edições da fila atual
main-queue-count:          {0} itens
main-queue-query:          A executar...
main-queue-reset:          Reinicializar
main-queue-clearall:       Remover edições de todas as filas
main-queue-options:        Gerir filas de edições...
main-goto:                 Ir para
main-goto-mytalk:          Minha página de discussão
main-goto-mycontribs:      Minhas edições
main-revision-decline:     Rejeitar revisão
main-revision:             Edição
main-revision-view:        Ver
main-revision-revert:      Reverter
main-revision-faith:       Reverter com boa fé
main-revision-previous:    Anterior
main-revision-next:        Seguinte
main-revision-latest:      Última
main-revision-sight:       Patrulhar
main-page-switchtotalk:    Mudar para a página de discussão
main-page-switchtosubject: Mudar para a página principal
main-page-switchtoarticle: Mudar para a página do artigo
main-page-viewlatest:      Ver a última edição
main-page-history:         Carregar história
main-page-historypage:     Mostrar página da história
main-page-edit:            Editar...
main-page-tag:             Marcar esta página com uma predefinição...
main-page-reqdeletion:     Propor para eliminar
main-page-reqprotection:   Pedir proteção
main-page-watch:           Vigiar
main-page-unwatch:         Deixar de vigiar
main-page-purge:           Atualizar
main-page-patrol:          Marcar como patrulhada
main-page-move:            Mover...
main-page-protect:         Proteger...
main-page-delete:          Eliminar...
main-page-restore:         Restaurar esta versão
main-user-info:            Mostrar informações do usuário
main-user-ignore:          Ignorar edições deste usuário
main-user-unignore:        Deixar de ignorar edições deste usuário
main-user-contribs:        Carregar contribuições do usuário
main-user-talk:            Ver página de discussão do usuário
main-user-message:         Enviar mensagem personalizada...
main-user-email:           Enviar email...
main-user-warn:            Avisar...
main-user-report:          Reportar
main-user-block:           Bloquear...
main-browser:              Navegador
main-browser-newtab:       Nova aba
main-browser-closetab:     Fechar aba
main-browser-closeothers:  Fechar todas as outras abas
main-browser-back:         Ver edição anterior do histórico de navegação
main-browser-forward:      Ver edição seguinte do histórico de navegação
main-browser-open:         Ver página no navegador externo
main-browser-newedits:     Mostrar automaticamente novas edições feitas na página
main-browser-newcontribs:  Mostrar automaticamente novas edições feitas pelo usuário
main-help:                 Ajuda
main-help-documentation:   Documentação
main-help-feedback:        Feedback
main-help-about:           Sobre o Huggle...
main-addqueue:             Adicionar...
main-savelogtitle:         Gravar relatório
main-usermessageother:     Outra mensagem...
main-advanced:             Avançado...
main-stats:                {0} edições por minuto, {1} reversões por minuto

main-tip-revertwarn:       Reverter esta edição e avisar o usuário
main-tip-nextdiff:         Mostrar a próxima edição a rever
main-tip-revert:           Reverter esta edição
main-tip-template:         Enviar uma mensagem predefinida ao usuário
main-tip-warn:             Avisar usuário
main-tip-cancel:           Cancelar todas as ações pendentes
main-tip-undo:             Desfazer minhas ações recentes
main-tip-browserback:      Anterior
main-tip-browserforward:   Seguinte
main-tip-browseropen:      Ver no navegador externo
main-tip-browsernewtab:    Nova aba
main-tip-browserclosetab:  Fechar aba
main-tip-history:          Carregar a história da página
main-tip-historyprev:      Mostrar edição anterior desta página
main-tip-historynext:      Mostrar edição seguinte desta página
main-tip-historylast:      Mostrar última edição desta página
main-tip-historydifftocur: Mostrar alterações entre esta edição e a última edição desta página
main-tip-contribs:         Carregar edições feitas pelo usuário
main-tip-contribsprev:     Mostrar edição anterior deste usuário
main-tip-contribsnext:     Mostrar edição seguinte deste usuário
main-tip-contribslast:     Mostrar última edição deste usuário
main-tip-pageview:         Ver esta edição
main-tip-pageedit:         Editar esta página
main-tip-pagewatch:        Vigiar esta página
main-tip-pagetag:          Marcar esta página com uma predefinição
main-tip-pagetagdelete:    Marcar esta página para eliminação
main-tip-pagedelete:       Eliminar esta página
main-tip-userinfo:         Mostrar informações sobre o usuário
main-tip-usertalk:         Mostrar a página de discussão do usuário
main-tip-usermessage:      Enviar mensagem a este usuário
main-tip-userignore:       Ignorar todas as edições deste usuário
main-tip-userreport:       Reportar este usuário
main-tip-userblock:        Bloquear este usuário
main-revision-acceptpend:  Aceitar esta revisão pendente
</pre>

=== Message form ===
<pre>
message-title:             Mensagem {0}
message-help:              Introduza um ou ambos os campos de Assunto e Sumário. Se não introduzir o sumário, será usado o assunto. Se não introduzir o assunto, não será criada uma secção.
message-subject:           Assunto:
message-message:           Mensagem:
message-summary:           Sumário:
message-autosign:          Adicionar automaticamente a assinatura no final da mensagem
</pre>

=== Move form ===
<pre>
move-title:                Mover {0}
move-target:               Destino:
move-reason:               Razão:
move-movetalk:             Mover também a página de discussão
</pre>

=== Prod form ===
<pre>
prod-title:                Marcar para eliminação semirrápida {0}
prod-reason:               Razão:
</pre>

=== Protect form ===
<pre>
protect-title:             Proteger {0}
protect-request-title:     Pedir proteção de {0}
protect-reason:            Razão:
protect-expiry:            Expiração:
protect-log:               Registo de proteção:
protect-currentlevel:      Nível de proteção atual:
protect-type:              Tipo de proteção:
protect-none:              Nenhuma
protect-semiprotection:    Semiproteção
protect-fullprotection:    Proteção total
protect-moveprotection:    Proteção de movimentos
</pre>

=== Queue form ===
<pre>
queue-title:               Fila de edições a rever
queue-queues:              Filas de edições a rever:
queue-typegroup:           Tipo de fila de edições a rever
queue-listselector:        Lista:
queue-listbuilder:         Construtor de listas...
queue-sortorder:           Ordem:
queue-removeviewed:        Remover edição da fila quando for visualizada
queue-removeold:           Remover edições anteriores feitas na mesma página
queue-removeafter:         Rem. edições após
queue-removeaftertime:     minutos
queue-preload:             Ativar pré-carregamento de edições quando esta fila de edições for selecionada
queue-ignorepages:         Ignorar edições nas páginas que estejam na lista de páginas ignoradas
queue-traynotification:    Mostrar notificação na barra de tarefas quando houver uma nova edição nesta fila
queue-diffsgroup:          Difs
queue-nodiffs:             Carregar difs apenas quando estiver a ver a edição
queue-preloaddiffs:        Carregar previamente os difs quando a fila estiver ativa
queue-alldiffs:            Carregar difs de todas as edições na fila
queue-pagefiltersgroup:    Filtros de títulos de páginas
queue-pageregex:           Título na expressão regular:
queue-namespaces:          Domínios:
queue-applylabel:          Clicar em Aplicar para aplicar estes filtros à lista de páginas existente.
queue-editfiltersgroup:    Editar filtros
queue-userregex:           Nome de usuário na expressão regular:
queue-summaryregex:        Sumário de edição na exp. regular:
queue-filternewpage:       Página nova
queue-filterownuserspace:  Pág. e subpáginas do usuário
queue-filteranonymous:     Usuário anónimo
queue-filterignored:       Usuário ignorado
queue-filterreverts:       Reverter
queue-filternotifications: Notificação
queue-filterwarnings:      Aviso
queue-filtertags:          Marcação com predefinição
queue-filterbot:           Edição de robô
queue-filterassisted:      Edição assistida
queue-filterhuggle:        Edição feita com o Huggle
queue-filterme:            Minhas edições
queue-examplelabel1:       Requerer este atributo
queue-examplelabel2:       Excluir este atributo
queue-examplelabel3:       Não verificar este atributo
queue-usergroup:           Mostrar apenas edições destes usuários
</pre>

=== Queue trim form ===
<pre>
queuetrim-title:           Remover edições da fila
queuetrim-age:             Retirar edições mais antigas do que
queuetrim-ageunit:         minutos
</pre>

=== Requests form ===
<pre>
requests-title:            Pedidos
requests-cancelall:        Cancelar tudo
requests-cancelled:        Cancelado
requests-inprogress:       A executar
requests-failed:           Falhou
requests-completed:        Executado
requests-time:             Hora
requests-type:             Tipo
requests-query:            Pedido
</pre>

=== Report form ===
<pre>
report-title:              Reportar {0}
report-reason:             Razão:
report-message:            Mensagem:
report-log:                Avisos para este usuário:
</pre>

=== Revert form ===
<pre>
revert-title:              Reverter {0}
revert-summary:            Sumário da reversão (para sumário padrão deixar em branco):
revert-currentonly:        Reverter apenas a edição selecionada
</pre>

=== Revert and warn form ===
<pre>
revertandwarn-title:       Reverter e avisar {0}
</pre>

=== Reverting ===
<pre>
revert-confirm-ignored:    Reverter edição do usuário '{0}' da lista branca?
revert-confirm-multiple:   Vai reverter várias edições do usuário '{0}'. Continuar?
revert-confirm-page:       Reverter a edição na página ignorada '{0}'?
revert-confirm-range:      O autor da edição para qual vai reverter, {1}, provavelmente é o mesmo autor da edição atual, {0}, por ser um IP da mesma gama; certifique-se se quer mesmo reverter para esta edição. Continuar?
revert-confirm-same:       Vai reverter para uma edição anterior do mesmo usuário, {0}. Continuar?
revert-confirm-self:       Vai reverter uma edição sua. Continuar?
revert-confirm-warned:     Vai reverter para uma edição de {0}; este usuário já foi avisado. Continuar?
revert-error-first:        Só existe uma edição nesta página por isso não é possível reverter.
revert-only:               A edição é a única existente na página.
revert-creator:            A última edição foi feita pelo criador da página, {0}.
revert-delete-instead:     Não será melhor eliminar a página?
revert-speedy-instead:     Não será melhor marcar para eliminação rápida?
</pre>

=== Speedy form ===
<pre>
speedy-title:              Marcar {0} para eliminação rápida
speedy-reason:             Razão:
speedy-parameters:         Parâmetros:
speedy-notifycreator:      Notificar o criador da página
</pre>

=== Statistics form ===
<pre>
stats-title:               Estatísticas
stats-actions:             Eventos nesta sessão:
stats-session:             Tempo decorrido da sessão: {0}
stats-edits:               Edições
stats-assisted:            Edições assistidas
stats-huggle:              Edições feitas com o Huggle
stats-reverts:             Reversões
stats-warnings:            Avisos
stats-reports:             Reportar a administradores
stats-tags:                Marcações
stats-notifications:       Notificações
stats-blocks:              Bloqueios
stats-deletes:             Eliminações
stats-protections:         Proteções
stats-allusers:            Todos os usuários
stats-me:                  Eu
stats-ignored:             Ignorados
stats-anon:                Anónimos
stats-bots:                Robôs
stats-other:               Outros
</pre>

=== Tag form ===
<pre>
tag-title:                 Marcar {0}
tag-tagselector:           Adicionar:
tag-tags:                  Marcações:
tag-summary:               Sumário:
tag-insertatend:           Inserir no final da página e não no início
</pre>

=== Update form ===
<pre>
update-title:              Nova versão disponível
update-notification:       Esta versão do Huggle está desatualizada.
update-required:           Tem de atualizar para a última versão, {0}.
update-optional:           Recomenda-se que atualize para a última versão, {0}, que poderá ser obrigatória futuramente.
update-prompt:             Descarregar e correr a última versão agora?
update-download:           Atualizar
update-progress:           A descarregar a nova versão...
update-error:              Não foi possível descarregar a nova versão.
</pre>

=== User info form ===
<pre>
userinfo-title:            Informações sobre o usuário '{0}'
userinfo-anonymous:        Anónimo:
userinfo-ignored:          Na lista branca:
userinfo-edits:            Número de edições:
userinfo-sessionedits:     Ed. nesta sessão:
userinfo-sharedip:         IP partilhado/dinâm.:
userinfo-blocklog:         Bloqueios:
userinfo-warnlog:          Avisos:
</pre>

=== Warning form ===
<pre>
warning-title:             Aviso {0}
warning-levelgroup:        Nível de aviso
warning-levelauto:         Automático
warning-level1:            Nível 1
warning-level2:            Nível 2
warning-level3:            Nível 3
warning-level4:            Nível 4 (final)
warning-warntype:          Tipo de aviso:
warning-warnlog:           Avisos a este usuário:
</pre>

=== XfD form ===
<pre>
xfd-title:                 Nomear {0} para eliminação
xfd-category:              Categoria:
xfd-nominationtype:        Tipo de nomeação:
xfd-notify:                Notificar o criador da página
xfd-reason:                Razão:
</pre>

=== Web requests ===
<pre>
error-apidisabled:         O MediaWiki API está desativado
error-exception:           Erro ao receber '{0}'
error-fail:                Não foi possível receber '{0}'
error-loggedout:           Saiu da sua conta de usuário, a entrar na conta...
error-noresponse:          Sem resposta
error-pagemissing:         A página não existe
error-reloginfail:         Não foi possível entrar de novo na conta, tente reiniciar o Huggle
error-timeout:             Foi excedido o tempo de resposta do servidor.
error-unknown:             Erro desconhecido

retrying:                  A tentar de novo...

block-done:                '{0}' bloqueado
block-fail:                O bloqueio de '{0}' falhou
block-progress:            A bloquear '{0}'...

blocklog-fail:             Erro ao receber o relatório de bloqueio para '{0}'
blocklog-none:             '{0}' nunca foi bloqueado
blocklog-progress:         A receber o relatório de bloqueios para '{0}'...

blocknotify-fail:          Não foi possível notificar '{0}' do bloqueio
blocknotify-progress:      A notificar '{0}' do bloqueio...

delete-done:               '{0}' foi eliminada
delete-fail:               Não foi possível eliminar '{0}'
delete-progress:           A eliminar '{0}'...

deletelog-fail:            Não foi possível receber o relatório de eliminação para '{0}'
deletelog-none:            Não existem entradas no relatório de eliminações para '{0}'
deletelog-progress:        A receber o relatório de eliminações para '{0}'...

diff-deleted:              Esta edição foi eliminada.
diff-fail:                 Não foi possível receber o dif de '{0}'

reqdelete-duplicate:       A página já foi proposta para eliminação
reqdelete-tagfail:         Não foi possível propor '{0}' para eliminação
reqdelete-redirectfail:    A página é um redirecionamento e não existe a página respetiva de proposta de eliminação
reqdelete-tagprogress:     A propor '{0}' para eliminação...

reqdelete-subpageprogress: A criar a página de proposta para eliminação de '{0}'...
reqdelete-subpagefail:     Não foi possível criar a página de proposta para eliminação de '{0}'
reqdelete-logprogress:     A adicionar '{0}' ao registo de páginas propostas para eliminação...
reqdelete-logfail:         Não foi possível adicionar '{0}' ao registo de páginas propostas para eliminação

edit-fail:                 Não foi possível editar '{0}'
edit-progress:             A editar '{0}'...

email-done:                Email enviado para '{0}'
email-fail:                Ocorreu um erro ao enviar o email para '{0}'
email-progress:            A enviar email para '{0}'...

history-fail:              Ocorreu um erro ao receber o histórico de '{0}'
history-progress:          A receber o histórico de '{0}' ({1})...

move-done:                 '{0}' movida para '{1}'
move-fail:                 Não foi possível mover '{0}' para '{1}'
move-progress:             A mover '{0}' para '{1}'...

notify-fail:               Não foi possível notificar o criador de '{0}'
notify-unknowncreator:     Não foi possível determinar o criador da página

patrol-duplicate:          Esta página já está patrulhada
patrol-done:               '{0}' marcada como patrulhada
patrol-fail:               Não foi possível marcar '{0}' como patrulhada
patrol-notfound:           Não foi possível encontrar o id nas mudanças recentes porque a página é demasiado antiga
patrol-progress:           A marcar '{0}' como patrulhada...

protect-done:              Nível de proteção de '{0}' foi alterado
protect-fail:              Não foi possível alterar o nível de proteção de '{0}'
protect-progress:          A alterar o nível de proteção de '{0}'...

protectlog-fail:           Não foi possível receber o registo de proteção de páginas para '{0}'
protectlog-none:           Não existe uma entrada no registo de proteção de páginas para '{0}'
protectlog-progress:       A receber o registo de proteção de páginas para '{0}'...

purge-done:                '{0}' recarregada
purge-fail:                Não foi possível recarregar '{0}'
purge-progress:            A recarregar '{0}'

queue-refresh-fail:        Ocorreu um erro ao atualizar a fila '{0}'

report-duplicate:          O usuário já foi reportado aos administradores
report-fail:               Não foi possível reportar '{0}' aos administradores
report-progress:           A reportar '{0}'...

saveuserconfig-done:       A página de configuração de usuário foi atualizada
saveuserconfig-fail:       Não foi possível atualizar a página de configuração de usuário
saveuserconfig-progress:   A atualizar a página de configuração de usuário

loadglobalconfig-fail:     Não foi possível carregar a página de configuração global
loadprojectconfig-fail:    Não foi possível carregar a página de configuração do projeto
loaduserconfig-fail:       Não foi possível carregar a página de configuração de usuário

reqprotection-badformat:   A página de pedidos tem um formato desconhecido pelo Huggle
reqprotection-duplicate:   A proteção já foi requisitada
reqprotection-fail:        Não foi possível pedir a proteção de '{0}'
reqprotection-progress:    A fazer o pedido de proteção de '{0}'...

revert-cannotundo:         Não foi possível desfazer as edições devido a conflitos de edições intermédias
revert-conflict:           A página foi editada pelo usuário da lista branca '{0}'
revert-fail:               Não foi possível reverter '{0}'
revert-nochange:           O conteúdo da edição para a qual quer reverter é idêntico à última edição
revert-nootheruser:        A página só foi editada por um usuário
revert-progress:           A reverter '{0}'...

tag-alreadytagged:         A página já está marcada
tag-deleted:               A página foi eliminada
tag-fail:                  Não foi possível marcar '{0}'
tag-progress:              A marcar '{0}'...

sight-done:                Marcar edição {0} de '{1}' como patrulhada
sight-fail:                Não foi possível marcar como patrulhada a edição {0} de '{1}'
sight-progress:            A marcar a edição {0} de '{1}' como patrulhada

speedy-fail:               Não foi possível marcar '{0}' para eliminação rápida
speedy-progress:           A marcar '{0}' para eliminação rápida...

warnlog-fail:              Não foi possível receber o registo de avisos de '{0}'
warnlog-none:              '{0}' não tem avisos do Huggle na pág. de discussão
warnlog-progress:          A receber o registo de avisos de '{0}'...

unwatch-done:              '{0}' removida da lista de páginas vigiadas
unwatch-fail:              Não foi possível remover '{0}' da lista de páginas vigiadas
unwatch-progress:          A remover '{0}' da lista de páginas vigiadas...

usermessage-duplicate:     Já existe uma mensagem sobre o mesmo assunto na página de discussão do usuário
usermessage-fail:          Não foi possível enviar a mensagem a '{0}'
usermessage-progress:      A enviar a mensagem a '{0}'...

watch-done:                '{0}' adicionada à lista de páginas vigiadas
watch-fail:                Não foi possível adicionar '{0}' à lista de páginas vigiadas
watch-progress:            A adicionar '{0}' à lista de páginas vigiadas...

warn-alreadyfinal:         O usuário já tem um aviso final
warn-alreadyblocked:       O usuário já foi bloqueado
warn-alreadyreported:      O usuário já foi reportado aos administradores
warn-oldedit:              O usuário não fez mais edições após o último aviso
warn-recent:               O usuário já foi avisado à menos de {0} segundos atrás
warn-fail:                 Não foi possível avisar '{0}'
warn-progress:             A avisar '{0}'...
</pre>

=== API ===
<pre>
api-help:                  Não existem parâmetros no API query
</pre>